术语类型：营养强化剂

维生素A		Vitamin A
β-胡萝卜素	Beta carotene
维生素D		Vitamin D
维生素E		VitaminE
维生素K		VitaminK
维生素	Vitamin
维生素 	Vitamin
维生素 	Vitamin
维生素	Vitamin
维生素C	VitaminC
烟酸|尼克酸	Niacin
叶酸	Folic acid
泛酸	Pantothenic acid
生物素	biotin
胆碱	choline
肌醇	inositol
铁	iron
钙	calcium
锌	Zinc|Zn
硒 Selenium|Se
镁	Magnesium|Mg
铜	Copper|Cu|cuprum
锰	Manganese|Mn
钾	Potassium|Kalium
磷	phosphorus|Phosphate|nitrogen
L-赖氨酸	l-lysine monohydrochloride|l-lysine)|l-lys
牛磺酸	Taurine|Tau|TaurineIUPAC
左旋肉碱|L-肉碱	l-carnitine
γ-亚麻酸	γlinolenic acid|gamma-linolenic acid|γ_linolenic acid
叶黄素	Lutein|xanthophyll|xanthophyll from alfalfa
低聚果糖FOS|Fructooligosaccharide|OLIGO
1,3-二油酸 2-棕榈酸甘油三酯	1, 3-dioleate, 2-palmitate, triglyceride
花生四烯酸|AA | ARA	Arachidonic acid |AA |ARA
二十二碳六烯酸|DHA	Docosahexaenoic acid|DHA
乳铁蛋白	lactotransferrin|Lactoferrin|LF
酪蛋白钙肽	CCP|Casein calcium peptide
酪蛋白磷酸肽	CPP|CaseinPhosphopeptides
钠	Sodium|Natrium
碘	iodine|Iodine
铬	Cr|Chromium
钼	Molybdenum|Mo
L-蛋氨酸|L-甲硫氨酸	l-met|l-methionine|L-methionine
L-酪氨酸	l-tyrosine|L-Tyrosine|L tyrosine
L-色氨酸	l-- tryptophan|l tryptophan|l-tryptophane


术语类型：化合物来源

醋酸视黄酯|醋酸维生素A	Retinol acetate
棕榈酸视黄酯|棕榈酸维生素A	Retinol palmitate
全反式视黄醇	Total trans-retino
β-胡萝卜素	Beta-Carotene|beta-carotene| ATC code D02BB01
麦角钙化醇|维生素	ergocalciferol|calciferol|Viosterol
胆钙化醇|维生素	Cholecalciferol|cholekalcyferol| kolekalcifero
d--生育酚	D - alpha tocopherol
dl--生育酚	dl-a-tocopherol|dl-α-tocopherol|DL α tocophero
d--醋酸生育酚	D-alpha tocopherol acetate
dl--醋酸生育酚	Tocopherol acetate
混合生育酚浓缩物	Mixed tocopherol concentrate		
维生素E琥珀酸钙	Calcium succinate vitamin E
d--琥珀酸生育酚	D-alpha succinate tocopherol
dl--琥珀酸生育酚		Tocopherol dl-alpha succinate
植物甲萘醌	phytoquinone
盐酸硫胺素	thiamine hydrochloride|thiamine|thiamine-hcl
硝酸硫胺素	Thiamin mononitrate|thiamine mononitrate
核黄素	Riboflavin|riboflavin|Vitamin
核黄素-5'-磷酸钠	Riboflavin -5'- sodium phosphate
盐酸吡哆醇	pyridoxine hydrochloride|Pyridoxine HCl|pyridoxine hydrochlorideusp
5'-磷酸吡哆醛	Pyridoxal 5-phosphate
氰钴胺	Cyanocobalamin|Vitamin|cyanocobamine
盐酸氰钴胺	Cyanocobalamin hydrochloride
羟钴胺	Hydroxocobalamin|hydroxocobalamin|acetate OHCbl
L-抗坏血酸	l-ascorbic acid|l-ascorbyl|l-ascorbic
L-抗坏血酸钙	Calcium diascorbate|calcium l ascorbate|calcium L ascorbate
维生素C磷酸酯镁	Vitamin C magnesium phosphate
L-抗坏血酸钠	L-sodium ascorbate
L-抗坏血酸钾	L-potassium ascorbate
L-抗坏血酸-6-棕榈酸盐|抗坏血酸棕榈酸酯	L-ascorbate -6-palmitate | ascorbate palmitate ester
烟酸	niacin|Nicotinic|acid Vitamin
烟酰胺	Nicotinamide|Niacinamide|VPP
叶酸|蝶酰谷氨酸	Folic acid|Folate|BC
D-泛酸钙	D - calcium pantothenate
D-泛酸钠	D - pantothenic acid sodium
D-生物素	Biotin|d-biotin|d biotin
氯化胆碱	Choline chloride|Choline hydrochloride|Choline
酒石酸氢胆碱	Choline bitartrate|choline bitartrate crystalline|Choline Bita
肌醇|环己六醇	Inositol|myo-Inositol|inosite
硫酸亚铁	ferrous sulfate|Iron(II) sulfate|ferrous sulphate
葡萄糖酸亚铁	Ferrous gluconate|ferrous gluconate hydrate|Iron D-gluconate dihydrat
柠檬酸铁铵	Ferric Ammonium Citrate|Ammonium ferric citrate|Ammonium ferril citrate brown
富马酸亚铁	Ferrous fumarate|Iron fumarate|Ferrous
柠檬酸铁	ferric citrate|Iron citrate|ferric citrate cell culture tested
乳酸亚铁	ferrous lactate|iron lactate|ferrous lactate hydrate
氯化高铁血红素	Hemin|protohemin焦磷酸铁
铁卟啉	ferriporphyrin|iron porphyrin|FeTPP
甘氨酸亚铁	Ferrous BisGlycinate|Ferrous Glycine Sulfate|Iron, bis
还原铁	reduced iron|Eisen reduziertes|Eisen
乙二胺四乙酸铁钠	EDTA ferric sodium salt|edta iron sodium salt|NaFeEDTA
羰基铁粉	carbonyl iron dust|carbonyl iron powder|carbonyl iron
碳酸亚铁	Ferrous carbonate|Ferric carbonate|iron carbonat
柠檬酸亚铁	Ferrous citrate|ferrous citrate
延胡索酸亚铁	Iron(II) fumarate|Ferrous Fumarate	
琥珀酸亚铁	Ferrous succinate|ferrous succinate
血红素铁	Haem iron|Heme iron|Hematin
电解铁	electrolytic iron|electroiron|Iron Electrolytic
碳酸钙	Calcium carbonate|calcium carbonate|CaCO
葡萄糖酸钙	calcium gluconate Glucose Gluconate calcii gluconas
柠檬酸钙	Calcium citrate|Calcium citrate tetrahydrate|CALCIUM CITRIC ACID
乳酸钙	calcium lactate|calcii lactas|GLUCO
L-乳酸钙	L-calcium lactate
磷酸氢钙	Dicalcium phosphate|DCP|Calcium Hydrogen Phosphate
L-苏糖酸钙	calcium L-threonate
甘氨酸钙	Calcium glycinate|Calcium Glycinate|Chelates Calcium glyc
天门冬氨酸钙	calcium aspartate|L-Aspartic acid calcium|salt l-calcium aspartate
柠檬酸苹果酸钙	Calcium citrate malate
醋酸钙|乙酸钙	Calcium Acetate|Lime acetate|Acetic acid calcium sal
氯化钙	Calcium Chloride|CaCl
磷酸三钙|磷酸钙	tricalcium phosphate|TCP|tertiary calcium phosphate
维生素E琥珀酸钙	Calcium succinate vitamin E
甘油磷酸钙	Calcium Glycerophosphate|Glycerol phosphate calcium salt|Glycerophosphoric acid calcium salt
氧化钙	calcium oxide|CaO|Calcium oxide
硫酸钙	Calcium sulfate|calcium sulfate|calcium sulphate
骨粉|超细鲜骨粉	bone meal|bone flour|bone powder
硫酸锌	Zinc sulfate
葡萄糖酸锌	zinc gluconate|Gluconic Acid Zinc|ZnG
甘氨酸锌	Glycine zinc|Zinc glycinateGly-Zn
氧化锌	Zinc Oxide|ZnO
乳酸锌	Zinc lactate|dl-lactic acid hemi-zinc|ZINC CITRATE
柠檬酸锌	Zinc citrate|zinc citrate dihydrate|Zinc citrate trihrate
氯化锌	Zinc chloride|zinc chloride|ZincChlorideCAS
乙酸锌	zinc acetate|Zinkacetat|Zinc acetate dihydrate
碳酸锌	zinc carbonate|ZnCOa|zinc carbonateusp
亚硒酸钠	Sodium Selenite|Sodium selenite pentahydrate|NaSeO
硒酸钠	sodium selenate|sodium selenate decahydrate|sodium-selenate
硒蛋白	Selenoprotein|Se-Containing protein|Selenium protein
富硒食用菌粉	Selenium-rich edible fungus powder
L-硒-甲基硒代半胱氨酸	L-selenium-methyl selenium-cysteine
硒化卡拉胶	Seleno-k-carrageenan|Selenium carrageenan|Se-KAPPA
富硒酵母	Selenium-Enriched|Yeast Yeasts|ppm
硫酸镁	magnesium sulfate|Magnesium sulfate|Magnesium sulfate heptahydrate
氯化镁	magnesium chloride|Magnesium chloride|MgCl
氧化镁	Magnesium oxide|MgO|magnesium oxide
碳酸镁	magnesium carbonate|carbonate of magnesia|MgCO
磷酸氢镁	Magnesium hydrogen phosphate|magnesium phosphate monobasic|Magnesium phosphate dibasic trihydrate
葡萄糖酸镁	Magnesium gluconate|magnesium D-gluconate hydrate
硫酸铜	Copper sulphate|copper(II) sulfate
葡萄糖酸铜	Copper gluconate|D-Gluconic acid, copper salt|D-Gluconic acid, coppersaltCAS
柠檬酸铜	Cupric citrate|ARCP
碳酸铜	copper(II) carbonate|copper carbonate|Mineral Green
硫酸锰	manganese sulfate|manganese(II) sulfate|manganese sulfate monohydrate
氯化锰	manganese(II) chloride|manganese chloride|MANGANESE ACETATE TE
碳酸锰	manganese(II) carbonate|Manganese carbonate|manganous carbonate
柠檬酸锰	Manganese citrate
葡萄糖酸锰	Manganese gluconate|MAGNESIUM GLUCONATE|Manganese as gluconate
葡萄糖酸钾	Potassium gluconate|Potassium D- gluconate|K-gluconate
柠檬酸钾	Potassium citrate|potassium citrate|Potassium citrate monohydrate
磷酸二氢钾	Monopotassium phosphate|MKP|Potassium Phosphate Monobasic
磷酸氢二钾	Dipotassium phosphate|DKP|Potassium hydrogen phosphate anhydrous
氯化钾	Potassium Chloride|potassium chloride|KCL
磷酸三钙|磷酸钙	tricalcium phosphate|TCP|tertiary calcium phosphate
磷酸氢钙	Dicalcium phosphate|DCP|Calcium Hydrogen Phosphate
L-盐酸赖氨酸		L-Lysine Hydrochloride|L-Lysine Mono Hcl|l-lysine monohydrochloride
L-L-赖氨酸天门冬氨酸盐		L-l-lysine aspartate
牛磺酸|氨基乙基磺酸	Taurine|Tau|TaurineIUPAC
左旋肉碱|L-肉碱		L-carnitine|LPC|L-ca greatrnitine
左旋肉碱酒石酸盐|L-肉碱酒石酸盐	L-carnitine tartaric acid
γ-亚麻酸	γ linolenic acid|gamma-linolenic acid|γ_linolenic acid
叶黄素	Lutein
低聚果糖	Oligofructose
1,3-二油酸 2-棕榈酸甘油三酯	1, 3-dioleate, 2-palmitate, triglyceride
花生四烯酸油脂	Arachidonic acid grease
二十二碳六烯酸油脂	Arochidonic Acid Oil|Arochidon
乳铁蛋白	lactotransferrin|Lactoferrin|LF
酪蛋白钙肽	CCP|Casein calcium peptide
酪蛋白磷酸肽	CPP|CaseinPhosphopeptides
抗坏血酸-6-棕榈酸盐|抗坏血酸棕榈酸酯	Ascorbic acid -6- palmitate
碳酸氢钠	Sodium Bicarbonate|sodium bicarbonate|Sodium hydrogen carbonate
磷酸二氢钠	monosodium phosphate|sodium dihydrogen phosphate|MSP
柠檬酸钠	Sodium Citrate|trisodium citrate|Trisodium citrate dihydrate
氯化钠	Sodium chloride|sodium chloride|NaCl
磷酸氢二钠	sodium hydrogen phosphate|DSP|Disodium phosphate dodecahydrate
乙二胺四乙酸铁钠	EDTA ferric sodium salt|edta iron sodium salt|NaFeEDTA
碘酸钾	potassium iodate|Potassium iodate|KIO
碘化钾	potassium iodide|KI|Potassium
碘化钠	sodium iodide|Sodium iodide|NaI
氯化铬	chromium chloride|chromium(III) chloride|Chromium chloride
钼酸钠	Sodium Molybdate|Sodium molybdate|Sodium Molybdate Dihydrate
钼酸铵	ammonium molybdate|Ammonium molybdate tetrahydrate|AHM
硫酸铬	chromium sulfate|chromic sulfate|Chromic sulphate hydrate
非动物源性	Non-animal origin


术语类型：食品添加剂

-阿朴 -8'- 胡萝卜素醛	-apo-8'-carotenal
氨基乙酸|甘氨酸	glycine
铵磷脂	Ammonium phosphatide
巴西棕榈蜡	Carnauba wax
白油|液体石蜡	mineral oil,white|liquid paraffin 
L-半胱氨酸盐酸盐	L-cysteine and its hydrochlorides sodium and potassium salts
苯甲酸	benzoic acid,sodium benzoate
冰结构蛋白	ice structuring protein
L-丙氨酸 L-alanine
丙二醇	propylene glycol
丙二醇脂肪酸酯	Propylene glyco lesters of fatty acid
丙酸	propionic acid,sodium propionate, calcium propionate
茶多酚|维多酚	tea polyphenol|TP 
茶多酚棕榈酸酯	tea polyphenol palmitate
赤藓红	erythrosine,erythrosine aluminum lake
刺梧桐胶	karaya gum
刺云实胶	tara gum
醋酸酯淀粉	starch acetate
单,双甘油脂肪酸酯|油酸|亚油酸|棕榈酸|山嵛酸|硬脂酸|月桂酸|亚麻酸	mono-and diglycerides of fatty acids
单辛酸甘油酯	capryl monoglyceride
淀粉磷酸酯钠	sodium starch phosphate
靛蓝	indigotine,indigotine aluminum lake
丁基羟基茴香醚|BHA	butylated hydroxyanisole|BHA
对羟基苯甲酸酯类|对羟基苯甲酸甲酯钠|对羟基苯甲酸乙酯		p-hydroxy benzoates and its salts( sodium methyl p-hydroxy benzoate , ethyl p-hydroxy benzoate , sodium ethyl p–hydroxy benzoate)
二丁基羟基甲苯|BHT	butylated hydroxytoluene|BHT
N- [ N - ( 3 , 3- 二甲基丁基)] -L-α- 天门冬氨 -L- 苯丙氨酸 1- 甲酯|纽甜	neotame
二甲基二碳酸盐|维果灵	dimethyl dicarbonate
2 , 4- 二氯苯氧乙酸	2 , 4-dichlorophenoxy acetic acid
二氧化硅	silicon dioxide
二氧化硫|焦亚硫酸钾|焦亚硫酸钠|亚硫酸钠|亚硫酸氢钠|低亚硫酸钠	sulfur dioxide, potassium metabisulphite , sodium metabisulphite , sodium sulfite , sodium hydrogen sulfite , sodium hyposulfite
二氧化钛	titanium dioxide
二氧化碳	carbon dioxide
番茄红	tomato red
番茄红素	lycopene
蜂蜡	beeswax
富马酸	fumaric acid
富马酸一钠	monosodium fumarate
甘草酸铵,甘草酸一钾及三钾	ammonium glycyrrhizinate , monopotassium and tripo-tassium glycyrrhizinate
甘草抗氧化物	antioxidant of glycyrrhiza
D- 甘露糖醇	D-mannitol
柑橘黄	orange yellow
高锰酸钾	Potassium permanganate
谷氨酰胺转氨酶	glutamine transaminase
瓜尔胶	guar gum
硅酸钙	calcium silicate
果胶	pectins
海萝胶	funoran|gloiopeltis furcata
海藻酸丙二醇酯	propylene glycol alginate
海藻酸钠|褐藻酸钠	sodium alginate
核黄素	riboflavin
黑豆红	black bean red
黑加仑红	black currant red
红花黄	carthamins yellow
红米红	Red rice red
红曲黄色素	monascus yellow pigment
红曲米,红曲红	red kojic rice , monascus red
β-胡萝卜素	beta-carotene
琥珀酸单甘油酯	succinylated monoglycerides
琥珀酸二钠	Disodium succinate
花生衣红	peanut skin red
滑石粉	talc
槐豆胶|刺槐豆胶	carob bean gum
环己基氨基磺酸钠|甜蜜素,环己基氨基磺酸钙	sodium cyclamate,calcium cyclamate
β-环状糊精	beta-cyclodextrin
黄原胶|汉生胶	xanthan gum
己二酸	Adipic acid
4-己基间苯二酚	4-hexylresorcinol
甲壳素|几丁质	chitin
姜黄	turmeric
姜黄素	curcumin
焦糖色(加氨生产)	caramel colour classⅢ-ammonia process
焦糖色(苛性硫酸盐)	caramel colour classⅡ-caustic sulfite
焦糖色(普通法)	caramel colour classⅠ-plain
焦糖色(亚硫酸铵法)	caramel colour classⅣ-ammonia sulphite process
金樱子棕	rose laevigata michx brown
L ( + ) -酒石酸,dl -酒石酸	L ( + ) -tartaric acid , dl -tartaric acid
酒石酸氢钾	potassium bitartarate
菊花黄浸膏	coreopsis yellow
聚二甲基硅氧烷及其乳液	polydimethyl siloxane and emulsion
聚甘油蓖麻醇酸酯|PGP	polyglycerol polyricinoleate|polyglycerol esters of interesterified ricinoleic acid|PGPR
聚甘油脂肪酸酯	polyglycerol esters of fatty acids|polyglycerol fatty acid esters
ε-聚赖氨酸	ε-polylysine
ε-聚赖氨酸盐酸盐	ε-polylysine hydrochloride
聚葡萄糖	Polydextrose
聚氧乙烯木糖醇酐单硬脂酸酯	polyoxyethylene xylitan monostearate
聚氧乙烯(20 )山梨醇酐单月桂酸酯|吐温20,聚氧乙烯(20 )山梨醇酐单棕榈酸酯|吐温40,聚氧乙烯(20 )山梨醇酐单硬脂酸酯|吐温60,聚氧乙烯(20 )山梨醇酐单油酸酯|吐温80	polyoxyethylene (20) sorbitan monolaurate ,polyoxyethylene ( 20 ) sorbitan monopalmitate ,
polyoxyethylene ( 20 ) sorbitan monostearate ,polyoxyethylene ( 20 ) sorbitan monooleat
聚乙二醇	polyethylene glycol
聚乙烯醇	 polyvinyl alcohol
决明胶	cassia gum
咖啡因	caffeine
卡拉胶	carrageenan
抗坏血酸|维生素C 	ascorbic acid|vitamin C
抗坏血酸钙	calcium ascorbate
抗坏血酸钠	sodium ascorbate
抗坏血酸棕榈酸酯	ascorbyl palmitate
可得然胶	curdlan
可可壳色	cocao husk pigment
可溶性大豆多糖	soluble soybean polysaccharide
喹啉黄	quinoline yellow
辣椒橙	paprika orange
辣椒红	paprika red
辣椒油树脂	paprika oleoresin
蓝锭果红	uguisukagura red
酪蛋白酸钠|酪朊酸钠	sodium caseinate
联苯醚|二苯醚	diphenyl ether|diphenyl oxide
亮蓝	brilliant blue,brilliant blue aluminum lake
磷酸, 焦磷酸二氢二钠, 焦磷酸钠, 磷酸二氢
钙, 磷酸二氢钾, 磷酸氢二铵, 磷酸氢二钾, 磷
酸氢钙, 磷酸三钙, 磷酸三钾, 磷酸三钠, 六偏
磷酸钠, 三聚磷酸钠, 磷酸二氢钠, 磷酸氢二
钠, 焦磷酸四钾, 焦磷酸一氢三钠, 聚偏磷酸
钾, 酸式焦磷酸钙		phosphoric acid,disodium dihydrogen pyrophosphate,tetrasodium pyrophosphate,calcium dihydrogen phosphate,potassium dihydrogen phosphate,diammonium hydrogen phosphate,dipotassium hydrogen phosphate,calcium hydrogen phosphate (dicalcium orthophosphate) ,tricalcium orthophosphate (calcium phosphate) ,tripotassium orthophosphate,trisodium orthophosphate,sodium polyphosphate,sodiumtripolyphosphate,sodium dihydrogen phosphate,sodium phosphatedibasic,tetrapotassium pyrophosphate,trisodium monohydrogen diphosphate, potassium polymetaphosphate,calcium acid pyrophosphate
磷酸化二淀粉磷酸酯	phosphated distarch phosphate
磷脂	phospholipid
硫代二丙酸二月桂酯	dilauryl thiodipropionate
硫磺	sulfur|sulphur
硫酸钙|石膏	calcium sulfate
硫酸铝钾|钾明矾,硫酸铝铵|铵明矾	aluminium potassium sulfate,aluminium ammonium sulfate
硫酸镁	magnesium sulfate
硫酸锌	zinc sulfate
硫酸亚铁	ferrous sulfate
氯化钙	calcium chloride
氯化钾	potassium chloride
氯化镁	magnesium chloride
罗望子多糖胶	tamarind polysaccharide gum
萝卜红	radish red
落葵红	basella rubra red
吗啉脂肪酸盐|果蜡	morpholine fatty acid salt|fruit wax
麦芽糖醇和麦芽糖醇液	maltitol and maltitol syrup
没食子酸丙酯|PG	propyl gallate |PG
玫瑰茄红	roselle red
迷迭香提取物	rosemary extract
迷迭香提取物(超临界二氧化碳萃取法)	rosemary extract
密蒙黄	buddleia yellow
木糖醇酐单硬脂酸酯	xylitan monostearate
纳他霉素	natamycin
柠檬黄	tartrazine,tartrazine aluminum lake
柠檬酸	citric acid,trisodium citrate,tripotassium citrate
柠檬酸铁铵	ferric ammonium citrate
柠檬酸亚锡二钠	disodium stannous citrate
柠檬酸脂肪酸甘油酯	citric and fatty acid esters of glycerol
偶氮甲酰胺	azodicarbonamide
偏酒石酸	metatartaric acid
葡萄皮红	grape skin extract
葡萄糖酸亚铁	ferrous gluconate
普鲁兰多糖	pullulan
羟丙基二淀粉磷酸酯	hydroxypropyl distarch phosphate
羟基硬脂精|氧化硬脂精	oxystearin
氢化松香甘油酯	glycerol ester of hydrogenated rosin
氢氧化钙	calcium hydroxide
氢氧化钾	potassium hydroxide
日落黄	sunset yellow,sunset yellow aluminum lake
溶菌酶	lysozyme
肉桂醛	cinnamaldehyde
乳酸	lactic acid
乳酸钙	calcium lactate
乳酸链球菌素	nisin
乳酸钠	sodium lactate
乳酸脂肪酸甘油酯	lactic and fatty acid esters of glycerol
乳糖醇|4-β-D 吡喃半乳糖-D-山梨醇		lactitol
乳糖酶	lactase
三氯蔗糖|蔗糖素	sucralose
桑椹红	mulberry red
沙蒿胶	rtemisiagum|sa-haoseed gum)
沙棘黄	hippophae rhamnoides yellow
山梨醇酐单月桂酸酯|司盘20 ,山梨醇酐单棕榈酸酯|司盘40 ,山梨醇酐单硬脂酸酯|司盘60,山梨醇酐三硬脂酸酯|司盘65,山梨醇酐单油酸酯|司盘80	sorbitan monolaurate,sorbitan monopalmitate,sorbitan monostearate,sorbitantristearate,sorbitan monooleate
山梨酸	sorbic acid,potassium sorbate
山梨糖醇和山梨糖醇液	sorbitol and sorbitol syrup
双乙酸钠|二醋酸钠	sodium diacetate
双乙酰酒石酸单双甘油酯	diacetyl tartaric acid ester of mono (di) glycerides (DATEM)
松香季戊四醇酯	pentaerythritol ester of wood rosin
酸性红|偶氮玉红	carmoisine|azorubine
酸枣色	jujube pigment
羧甲基淀粉钠	sodium carboxy methyl starch
羧甲基纤维素钠	sodium carboxy methyl cellulose
索马甜	thaumatin
碳酸钙	calcium carbonate
碳酸钾	potassium carbonate
碳酸镁	magnesium carbonate
碳酸钠	sodium carbonate
碳酸氢铵	ammonium hydrogen carbonate
碳酸氢钾	potassium hydrogen carbonate
碳酸氢钠	sodium hydrogen carbonate
碳酸氢三钠|倍半碳酸钠	sodium sesquicarbonate
糖精钠	sodium saccharin
特丁基对苯二酚(TBHQ)	tertiary butylhydroquinone (TBHQ)
L-α-天冬氨酰-N-(2,2,4,4-四甲基-3-硫化三亚甲基)-D-丙氨酰胺|阿力甜	alitame
天门冬酰苯丙氨酸甲酯|阿斯巴甜	aspartame
天门冬酰苯丙氨酸甲酯乙酰磺胺酸	aspartame-acesulfame salt
天然苋菜红	natural amaranthus red
田菁胶	sesbania gum
甜菊糖苷	steviol glycosides
脱氢乙酸|脱氢醋酸	dehydroacetic acid|sodium dehydroacetate
脱乙酰甲壳素|壳聚糖	deacetylated chitin|chitosan
微晶纤维素	microcrystalline cellulose
维生素E(dl-α-生育酚,d-α-生育酚,混合生育酚浓缩物)	vitamineE (dl-α-tocopherol,d-α-tocopherol,mixed tocopherol concentrate)
稳定态二氧化氯	stabilized chlorine dioxide
苋菜红	amaranth,amaranth aluminum lake
橡子壳棕	acorn shell brown
硝酸钠,硝酸钾	sodium nitrate,potassium nitrate
辛,癸酸甘油酯	octyl and decyl glycerate
辛烯基琥珀酸淀粉钠	starch sodium octenyl succinate|sodium starch octenyl succinate
新红	new red,new red aluminum lake
亚麻籽胶|富兰克胶	linseed gum
亚铁氰化钾,亚铁氰化钠	potassium ferrocyanide,sodium ferrocyanide
亚硝酸钠,亚硝酸钾	sodium nitrite,potassium nitrite
胭脂虫红	carmine cochineal
胭脂红	ponceau4R,ponceau4R aluminum lake
胭脂树橙|红木素,降红木素	annatto extract
盐酸	hydrochloric acid
杨梅红	mynica red
氧化铁黑,氧化铁红	iron oxide black,iron oxide red
叶黄素	lutein
叶绿素铜	copper chlorophyll
叶绿素铜钠盐|叶绿素铜钾盐	chlorophyllin copper complex,sodium and potassium salts
液体二氧化碳(煤气化法)	carbon dioxide
乙二胺四乙酸二钠	disodium ethylene-diamine-tetra-acetate
乙二胺四乙酸二钠钙	calcium disodium ethylene-diamine-tetra-acetate
乙酸钠|醋酸钠	sodium acetate
乙酰磺胺酸钾|安赛蜜	acesulfame potassium
乙氧基喹	ethoxy quin
异构化乳糖液	isomerized lactose syrup
D-异抗坏血酸	D-isoascorbic acid (erythorbic acid),sodium D-isoascorbate
异麦芽酮糖	isomaltulose|palatinose
硬脂酸|十八烷酸	stearic acid|octadecanoic acid
硬脂酸钙	calcium stearate
硬脂酸钾	potassium stearate
硬脂酸镁	magnesium stearate
硬脂酰乳酸钠,硬脂酰乳酸钙	sodium stearoyl lactylate,calcium stearoyl lactylate
诱惑红	allura red,alluraa luminum lake
玉米黄	corn yellow
越橘红	cowberry red
藻蓝	spirulina blue (algae blue,lina blue)
皂荚糖胶	gleditsia sinenis lam gum
蔗糖脂肪酸酯	sucrose esters of fatty acid
栀子黄	gardenia yellow
栀子蓝	gardenia blue
植酸|肌醇六磷酸,植酸钠	phytic acid|inositol hexaphosphoric acid,sodium phytate
植物炭黑	vegetable carbon,carbon black
竹叶抗氧化物	antioxidant of bamboo leaves
紫草红	gromwell red
紫甘薯色素	purple sweet potato colour
紫胶|虫胶	shellac
紫胶红|虫胶红	lacdyered|lacred

术语类型：食品用天然香料


丁香叶油	Clove leaf oil|Eugenia spp
丁香花蕾酊(提取物)	Clove bud tincture (extract)|Eugenia spp
丁香花蕾油	Clove bud oil|Eugenia spp
罗勒油	Basil oil|Ocimum basilicum L
八角茴香油	Anise star oil|Illicium verum Hook , F
九里香浸膏	Common Jasmin orange concrete|Murra ya paniculata 
广藿香油	Patchouli oil|Pogostemon cablin
万寿菊油	Tagetes oil|Tagetes spp
大茴香脑	trans -Anethole|Anise camphor
小豆蔻油	Cardamom oil|Elletaria cardamomum
小豆蔻酊	Cardamom tincture|Elletaria cardamomum
小茴香酊	Fennel tincture|Foeniculum vulgare Mill
山苍子油	Litsea cubeba berry oil
山楂酊	Hawthorn fruit tincture|Crataegus spp
大蒜油	Garlic oil|Allium sativum L
大蒜油树脂	Garlic oleoresin|Allium sativum L
天然康酿克油	Cognac oil , green 
天然薄荷脑	L -Menthol , natural
云木香油	Costus root oil|Saussures lappa Clanke
月桂叶油	Bay , sweet , oil|Laurus nobilis L
乌梅酊	Wumei tincture|Prunus mume
布枯叶油	Buchu leaves oil|Barosma spp
可可酊	Cocoa tincture|Theobroma cacao Linn
可可壳酊	Cocoa husk tincture|Theobroma cacao Linn
甘松油	China nardostachys oil|Nardostachys chinensis Batal
甘草酊	Licorice tincture|Glycyrrhiza spp
甘草流浸膏	Licorice extract|Glycyrrhiza spp
冬青油	Wintergreen oil|Gaultheria procumbens L
白兰花油	Michelia alba flower oil
白兰叶油	Michelia alba leaf oil
白兰花净油	Michelia alba flower absolute
白兰花浸膏	Michelia alba flower concrete
白芷酊	Angelica dahurica tincture
白柠檬油	Lime oil|Citrus aurantifolia(Christman)Swingle
白柠檬萜烯	Lime oil terpene
生姜油树脂	Ginger oleoresin|Zingiber officinale Rosc
肉豆蔻油	Nutmeg oil|Myristica fragrans Houtt
肉豆蔻酊	Nutmeg tincture|Myristica fragrans Houtt
中国肉桂油	Cassia oil|Cinnamomum cassia Blume
中国肉桂皮酊(提取物)	Cassia bark tincture (extract)|Cinnamomum cassia Blume
红茶酊	Black tea tincture|Camellia sinensis
印蒿油	Davana oil|Artemisia pallens Wall
吐鲁酊(提取物)	Tolu balsam tincture (extract)|Myroxylon spp
吐鲁香膏	Tolu balsam gum|Myroxylon spp
豆豉酊	Soya bean fermented tincture
杜松籽油|刺柏子油	Juniper berry oil|Juniperus communis L
芫荽籽油	Coriander oil|Coriandrum sativum L
芹菜花油	Celery flower oil|Apium graveolens L
芹菜籽油	Celery seed oil|Apium graveolens L
牡荆叶油	Vitex cannabifolia leaf oil
圆柚油	Grapefruit oil , expressed|Citrus paradisi Mact
苍术脂|苍术硬脂,苍术油	Atractylodes oil|Atractylodes lancea
枣子酊	Chinese date(common Jujube)tincture|Ziziphus jujuba Mill
玫瑰油	Rose oil|Rosa spp
玫瑰净油	Rose absolute|Rosa spp
玫瑰浸膏	Roseconcrete|Rosa spp
鸢尾浸膏	Orris concrete|Iris florentina L
鸢尾脂|鸢尾凝脂	Orris root extract|Iris florentina L
杭白菊花油	Chrysanthemum Hang Zhou flower oil|Dendranthema morifolium or Chrysanthemum morifolium )
杭白菊花浸膏|杭菊花流浸膏	Chrysanthemum Hang Zhou flower extract|Dendranthema morifolium or Chrysanthemum morifolium
枫槭油	Maple oil|Acer spp
枫槭浸膏	Maple concrete|Acer spp
岩蔷薇浸膏|赖百当浸膏	Labdanum extract|Cistus ladaniferus
咖啡酊	Coffee tincture|Coffee spp
罗汉果酊	Luohanfruit tincture|Siraitia grosvenorii(Swingle) C.Jeffrey
金合欢浸膏	Cassie concrete|Acacia farnesiana Willd
依兰依兰油	Ylang ylang oil|Cananga odorata Hook.f.and Thomas
大花茉莉净油	Jasminum grandiflorum absolute
大花茉莉浸膏	Jasminum grandiflorum concrete
小花茉莉净油	Jasminum sambac absolute
小花茉莉浸膏	Jasminum sambac concrete
佛手油	Sarcodactylis oil|Citrus medica var. Sarcodactylis Swingle
圆叶当归根酊|独活酊	Angelica root tincture (extract)|Angelica archangelica L
洋葱油	Onion oil|Allium cepa L
生姜油	Ginger oil|Zingiber officinale Rosc
姜黄油	Turmeric oil|Curcuma longa L
姜黄油树脂	Turmeric oleoresin|Curcuma longa L
姜黄浸膏	Turmeric extract|Curcuma longa L
葫芦巴酊	Fenugreek tincture (extract)| Trigonella foenum graecum L
玳玳花油	Daidai flower oil|Citrus aurantium L.'Daidai'
玳玳花浸膏	Daidai flower concrete|Citrus aurantium L.'Daidai'
玳玳果油	Daidai fruit oil|Citrus aurantium L.'Daidai'
柚皮油	Pummelo peel oil|Citrus grandis (L.) Osbeck
柏木叶油(北美香柏)	Cedar leaf oil|Thuja occidentalis L
枯茗籽油|孜然油	Cumin seed oil|Cuminum cyminum L
柠檬油	Lemon oil|Citrus limon (L.) Burm.f
无萜柠檬油	Lemon oil , terpeneless|Citruslimon (L.)Burm. f
柠檬油萜烯	Terpenes of lemon oil
柠檬叶油	Petitgrain lemon oil|Citrus limon(L.)Burm. f
柠檬草油	Lemongrass oil |Cymbopogon citratus DC.and C. flexuosus
栀子花浸膏	Gardenia flower concrete|Gardenia jasminoides Ellis
树兰花油	Aglaia odorata flower oil
树兰花酊	Aglaia odorata flower tincture
树兰花浸膏	Aglaia odorata flower concrete
树苔净油	Treemoss absolute|Evernia furfuraceae 
树苔浸膏	Treemoss concrete|Evernia furfuraceae
香叶油|玫瑰香叶油	Geranium oil| geranium rose oil|Pelargonium graveolens L' Her
除萜香叶油	Geranium oil terpeneless
香风茶油|香茶菜油	Xiang Feng cha oil| Rabdosia spp
香柠檬油	Bergamot oil|Citrus aurantium L.subsp.bergamia
香根油	Vertiver oil|Vetiveria zizanioides Nash
香根浸膏	Vertiver concrete|Vetiveria zizanioides Nash 
香荚兰豆酊	Vanilla bean tincture|Vanilla spp
香荚兰豆浸膏(提取物)	Vanilla bean concrete ( extract )|Vanilla spp
香附子油	Cyperus oil|Cupressus sem pervirens
香葱油	Chives oil|Allium schoeno prasum
香紫苏油	Clary sage oil|Salvia sclarea L
香榧子壳浸膏	Torreya grandis shell concrete
橘子油	Mandarin oil|Citrus reticulata Blanco
除萜橘子油	Mandarin oil , terpeneless
酒花酊	Hops tincture (extract)|Humulus lupulus L
酒花浸膏	Hops extract, solid|Humulus lupulus L
桉叶油(蓝桉油)	Eucalyptus oil|Eucalyptus globulus Labille
海狸酊	Castoreum tincture (extract)|Castor spp
斯里兰卡肉桂皮油	Cinnamon bark oil|Cinnamomum spp
斯里兰卡肉桂叶油	Cinnamon leaf oil|Cinnamomum spp
桂花净油	Osmanthus fragrans flower absolute
桂花酊	Osmanthus fragrans flower tincture
桂花浸膏	Osmanthus fragrans flower concrete
桂圆酊	Longan tincture|Euphoria longana
留兰香油	Spearmint oil|Mentha spicata
核桃壳提取物	Walnut hull extract|Juglans spp
素方花净油	Common white jasmine flower absolute|Jasminum officinale L
桦焦油	Birch sweet oil|Betula lenta L
蚕豆花酊	Broad bean flower tincture|Vicia faba Linn
绿茶酊	Green tea tincture|The asinensis or Camellia sinensis
野玫瑰浸膏	Wild rose concrete|Rosa multiflora
甜小茴香油	Fennel oil,sweet|Foeniculum vulgare Mill.var. dulce D.C
甜叶菊油	Stevia rebaudiana oil
甜橙油	Orange oil|Citrus sinensis (L.) Osbeck
除萜甜橙油	Orange oil , terpeneless|Citrus sinensis (L.)Osbeck
甜橙油萜烯	Terpenes of orange oil
菊苣浸膏	Chicory concrete (extract)|Cichorium intybus L
晚香玉浸膏	Tuberose concrete|Polianthes tuberosa
紫罗兰叶浸膏	Violet leaf concrete|Viola odorata
椒样薄荷油	Peppermint oil|Mentha piperita L
黑加仑酊	Black currant tincture|Ribes nigrum L
黑加仑浸膏	Black currant concrete|Ribesnigrum L
槐树花净油	Sophora japonica flower absolute
槐树花浸膏	Sophora japonica flower concrete
辣椒酊	Capsicum tincture (extract)|Capsicum spp
辣椒油树脂|灯笼辣椒油树脂	Paprika oleoresin|Capsicum annuum L
愈疮木油	Guaiac wood oil|Bulnesia sarmienti Lor
缬草油	Valerian root oil|Valeriana officinalis L
墨红花净油	Rose crimsonglory flower absolute
墨红花浸膏	Rose crimsonglory flower concrete
橙叶油	Petitgrain bigarade oil|Citrus aurantium L
亚洲薄荷油	Mentha arvensis oil|Cornmint oil
亚洲薄荷素油	Mentha arvensis oil,partially dementholized
檀香油	Sandalwood oil|Santalum album L
薰衣草油	Lavender oil|Lavandula angustifolia
头状百里香油|西班牙牛至油	Origanum oil|Thymus capitatus
可乐果提取物	Kolas nut extract|Cola acuminate Schott et EndL
加州胡椒油	Schinus molle oil|Schinus molle L
卡黎皮油	Cascarilla bark oil|Croton spp
百里香油	Thyme oil|Thymus vulgaris or zigis L
奶油发酵起子蒸馏物(黄油蒸馏物)	Butter starters distillate
卡南伽油	Cananga oil|Cananga odorata Hook.F.and Thoms
月桂叶提起物/油树脂	Laurel leaves extract/oleoresin|Laurus nobilis L
生姜提取物(生姜浸膏)	Ginger extract (Ginger concrete)|Zingiber officinale
白栎木屑提取物	Oak chips extract|Quercus alba L
龙蒿油	Estragon oil|Artemisia dracunculus L
白樟油	Camphor oil , white|Cinnamomum camphora(L.) Presl
肉豆蔻衣油	Mace oil|Myristica fragrans Houtt
众香叶油	Pimento leaf oil|Pimenta officinalis Lindl
西班牙鼠尾草油	Sage oil,Spanish|Salvia lavandulaefolia VahL
红橘油	Tangerine oil|Citrus reticulata Blanco
杂薰衣草油	Lavandin oil|Lavandula hydrida
杏仁油	Apricot Kernel oil|Prunus armeniaca L
苏合香油	Styrax oil|Liquidambar spp
苏合香提取物	Styrax extract|Liquidambar spp
长角豆油	Locust bean oil|Ceratonia siliqua L
角豆提取物	Carob bean extract|Ceratonia siliqua L
皂树皮提取物	Quillaia|Quillaja saponaria Molina
乳香油	Olibanum oil|Boswellia spp
没药油	Myrrh oil|Commiphora spp
良姜根提取物	Galangal root extract|Alpinia spp
苏格兰松油	Pine oil , scotch|Pinus sylvestris L
小茴香油|普通小茴香油	Fennel oil,(common)| Foeniculumvulgare Mill
苦杏仁油	Almond oil , bitter|Prunus amygdalus
阿魏油	Asafoetida oil|Ferula asafoetida L
金合欢净油	Cassie absolute|Acacia farnesiana(L.)Willd
欧芹叶油	Parsley leaf oil|Petroselinum crispum
松针油	Pine needle oil|Abies spp
波罗尼花净油	Boronia absolute|Boronia megastigma Nees
玫瑰木油	Bois de rose oil|Aniba rosaeodora Ducke
玫瑰草油	Palmarosa oil|Cymbopogon martini (Roxb.)Stapf
香茅油	Citronella oil|Cymbopogon nardus Rendle
迷迭香油	Rosemary oil|Rosemarinus officinalis L
香脂冷杉油	Balsam fir oil|Abies balsamea(L.)Mill
香脂冷杉油树脂	Balsam fir oleoresin|Abies balsamea (L.)Mill
胡萝卜籽油	Carrot seed oil|Daucus carota L
春黄菊花油(罗马)	Chamomile flower oil (Roman)|Anthemis nobilis L
春黄菊花净油(提取物)(罗马)	Chamomile flower absolute (extract)(Roman)|Anthemis nobilis L
药鼠李提取物	Cascara bitterless extract|Rhamnus purshiana DC
荜澄茄油	Cubeb oil|Piper cubeba L.f
胡薄荷油|唇萼薄荷油	Pennyroyal oil|Mentha pulegium L
欧当归油	Lovage oil|Levisticum officinale Koch
夏至草提取物	Horehound extract|Marrubium vulgare L
莫哈弗丝兰提取物	Yucca mohave extract|Yucca spp
海草(藻)提取物	Kelp|Laminaria and Kereocystis spp
海索草油	Hyssop oil|Hyssopus officinalis L
莳萝草油|莳萝油	Dill herb oil|Anethum graveolens
秘鲁香脂	Balsam peru|Myroxylon pereirae Klotzsch
格蓬油	Galbanum oil|Ferula galbaniflua
脂檀油	Amyris oil|Amyris balsamifera L
银白金合欢净油|含羞草净油	Mimosa absolute|Acacia decurrens Will.Var. dealbata
接骨木花净油	Elder flower absolute|Sambucus canadensis L.andS. nigra L
甘牛至油	Marjoram oil,sweet|Majorana hortensis Moench (Origanum majorana L.)
黄龙胆根提取物	Gentian root extract|Gentiana lutea L
黄葵籽油	Ambrette seed oil|Hibiscus abelmoschus L
野黑樱桃树皮提取物	Cherry bark extract (wild)|Prunus serotina Ehrh
黑胡椒油	Pepper oil,black|Piper nigrum L
葛缕籽油	Caraway seed oil|Carum carvi L
榄香香树脂	Elemi resinoid|Canarium ssp
蜡菊提取物	Immortelle extract|Helichrysum angustifolium DC
蜜蜂花油	Balm oil|Melissa officinalis L
d-樟脑	d-Camphor
橙花净油	Orange flower absolute|Citrus aurantium L.subsp. amara
柚苷(柚皮甙提取物)	Naringin extract|Citrus paradisi Macf
穗薰衣草油	Spike lavender oil|Lavandula latifolia L
鹰爪豆净油	Genet absolute|Spartium junceum L
玳玳果皮油	Daidai peel oil|Citrus aurantium L.'Daidai'
甜橙油(橙皮压榨法)	Orange oil,sweet,cold pressed|Citrus sinensis(L.)osbeck
小米辣椒油树脂	Bush red pepper oleoresin|Capsicum frutescens L
丁香茎油	Clove stem oil|Eugenia spp
大茴香油|茴芹油	Anise oil|Pimpinella anisum L
l-天冬酰胺	l-Asparagine
巴拉圭茶净油/提取物	Mate absolute/extract|Ilex paraguariensis St.Hil
白山核桃树皮提取物	Hickory bark extract|Carya spp
瓜拉纳提取物	Guarana extract|Paullinia cupana HBK
白百里香油	Thyme oil,white|Thymus zygis L
白胡椒油	Pepper oil , white|Piper nigrum L
白胡椒油树脂	Pepper oleoresin,white|Piper nigrum L
白康酿克油	Cognac oil,white
白脱酯	Butter esters
白脱酸	Butter acids
众香果油	Pimenta oil|Pimenta officinalis
安息香树脂	Benzoin resinoid|Styrax tonkinensis Pierre
当归籽油	Angelica seed oil|Angelica archanglica L
当归根油	Angelica root oil|Angelica archangelica L
肉豆蔻衣油树脂/提取物	Mace oleoresin/extract|Myristica fragrans Houtt
西印度月桂叶提取物	Bay leaves,west Indian , extract|Pimenta acris kostel
西印度月桂叶油	Bay leaves,West Indian,oil|Pimenta acris kostel
L- 阿拉伯糖(原名称为l-阿戊糖)		 L-Arabinose
阿拉伯胶	Arabic gum
欧当归提取物	Lovage extract|Levisticum officinale Koch
欧芹油树脂	Parsley oleoresin|Petroselinum spp
油酸	Oleic acid
苦木提取物	Quassia extract|Picrasma excelsa(sw.) planch. Quassia amara L
苦橙叶净油	Orange leaf absolute|Citrus aurantium L
苦橙油	Orange oil,bitter|Citrus aurantium L
金鸡纳树皮	Cinchona bark (yellow)|Cinchona spp
金钮扣油树脂	Jambu oleoresin|Spilanthes acmelia oleracea
奎宁盐酸盐	Quinine hydrochloride
枯茗油	Cumin oil|Cuminum cyminum L
洋葱油树脂	Onion oleoresin|Alliumcepa L
茶树油|互叶白千层油	Teatree oil|Melaleucaalternifolia
除萜白柠檬油	Lime oil , expressed terpeneless|Citrus aurantifolia Swingle
除萜甜橙皮油	Orange peel oil,sweet, terpeneless|Citrus sinensis L.Osbeck
黄芥末提取物/黄芥末油树脂	Mustard extract/oleoresin,yellow|Brassica spp
棕芥末提取物	Mustard extract,brown|Brassica spp
焦木酸	Pyroligneous acid
紫苏油	Perilla leaf oil|Shisooil|Perillafrutescens
葡萄柚油萜烯	Grapefruit oil terpenes|Citrus paradisi Macf
黑胡椒油树脂/黑胡椒提取物	Pepper oleoresin/extract,black|Piper nigrum L
榄香油/提取物/香树脂 Elemi oil/extract/resinoid|Canarium cimmune or Iuzonicum Miq
蜂蜡净油	Beeswax absolute|Apis mellifera L
赖百当净油|岩蔷薇净油	Labdanum absolute|Cistus spp
鼠尾草油|药鼠尾草油	Sage oil|Salvia officinalis L
蜡菊净油	Helichrysum absolute|Helichrysum augustifolium
糖蜜提取物	Molasses extract
檀香醇(α- ,β- )	 Santalol,α- and β -
山达草流浸膏	Yerba santa fluid extract|Eriodictyon californicum (HookandArn) Torr
苜蓿提取物	Alfalfa extract|Medicago sativa L
众香子油树脂/提取物	Allspice oleoresin/extract|Pimenta officinalis Lindl
黄葵籽净油	Ambrette seed absolute|Hibiscus abelmoschus L
秘鲁香膏油	Balsam oil,Peru|Myroxylon pereirae Klotzsch
罗勒提取物	Basil extract|Ocimum basilicum L
芹菜籽提取物(固体)	Celery seed extract solid|Apium graveolens L
芹菜籽( CO2)提取物	Celery seed(CO2) Extract|Apium graveolens L
母菊(匈牙利春黄菊)花油	Chamomile flower oil (Hungarian)|Matricaria chamomilla L
黄色金鸡纳树皮提取物	Cinchona bark extract (yellow)|Cinchona spp
丁香花蕾油树脂	Clove bud oleoresin|Eugenia spp
红三叶草提取物(固体)	Clover tops red extract solid|Trifolium pratense L
蒲公英流浸膏	Dandelion fluid extract|Taraxacum spp
蒲公英根固体提取物	Dandelion root solid extract|Taraxacum spp
加拿大飞蓬草油	Fleabane oil|Erigeron canadensis
穗花槭提取物(固体)	Mountain maple extract solid|Acer spicatum Lam
芸香油	Rue oil|Ruta graveolens L
鼠尾草油树脂/提取物	Sage oleoresin/extract|Salvia officinalis L
菝葜提取物	Sarsaparilla extract|Smilax spp
水蒸气蒸馏松节油	Turpentine,steam-distilled|Pinus spp
缬草根提取物	Valerian root extract|Valeriana officinalis L
香荚兰油树脂	Vanilla oleoresin|Vanilla fragrans
紫罗兰叶净油	Violet leaves absolute|Viola odorata L
洋艾油	Worm wood oil|Artemisia absinthium L
玫瑰茄	Roselle|Hibiscus sabdariffa L
橘柚油	Tangelo oil
晚香玉净油	Tuberose absolute|Polianthes tuberosa L
美国栗树叶提取物	Chestnut leaves extract|Castanea dentate(Marsh.) Borkh
古巴香脂油	Copaiba oil|South American spp.of Copaifera
达迷草叶	Damiana leaves|Turnera diffusa Willd
母菊(匈牙利春黄菊)花净油	Chamomile flower absolute (Hungarian )|Matricaria chamomilla L.
接骨木花提取物	Elder flowers extract|Sambucus canadensis L.and S. nigra L
防风根油|没药油	Opoponax oil|Commiphora ssp
藏红花提取物	Saffron extract|Crocus sativus L
香叶提取物	Geranium extract|Pelargonlium spp
葫芦巴油树脂	Fenugreek oleoresin|Trigonella foenumgraecum L
柠檬提取物	Lemon extract|Citrus limon(L.)Burm.f
德国鸢尾树脂	Orris resinoid|Iris germanical L
罗望子提取物(浸膏)	Tamarind extract|Tamarindus indica L
辣根油	Horseradish oil|Armoracia lapathifolia Gilib
葫芦巴籽浸膏	Fenugreek seed extract|Trigonella foenumgraecum L
芹菜叶油	Celery leaf oil|Apium graveolens L
柏木油萜烯	Cedarwood oil terpenes
肉豆蔻油树脂	Nutmeg oleoresin|Myristica fragrans Houtt
芫荽油/油树脂	Coriander oil/oleoresin|Coriandrum sativum L
葫芦巴	Fenugreek|Trigonella foenum-graecum L
韭葱油	Leek oil|Allium porrum
甜橙皮提取物	Orange peel extract,sweet|Citrus sinensis(L.) Osbeck
香橙皮油	Citrus junos peel oil
海藻净油	Algues absolute
墨西哥鼠尾草油树脂|棘枝油树脂|墨西哥牛至油树脂	Oregano oleoresin|Lippia spp
甘草酸胺	Glycyrrhizin,ammoniated|Glycyrrhiza spp
冬香草油	Savory winter oil|Satureja montana L
安息香	Styrax|Liquidambar spp
阿魏液态提取物(流浸膏)	Asafoetida fluid extract(Ferula assafoetida L.)
桃树叶净油	Peach tree leaf absolute|Prunus persica L.Batsch
白藓牛至	Dittany of crete|Origanum dictamnus L
酒花油	Hops oil|Humulus lupulus L
赖百当油	Labdanum oil|Cistus ladaniferus
薰衣草净油	Lavender absolute|Lavandula angustidolia
没药树脂提取物	Opoponax extract resinoid|Commiphora ssp
花椒提取物	Ash bark,prickly,extract|Zanthoxylum spp
蓖麻油	Castor oil|Ricinus communis
儿茶粉	Catechu powder|Acacia catechu Willd
苦艾	Wormwood|Artemisia absinthium L
苦橙花油	Neroli bigarade oil|Citrus aurantium L
达瓦树胶	Ghatti gum|Anogeissus latifolia Wall
苦艾提取物	Wormwood extract|Artemisia absinthium L
刺柏提取物	Juniper extract|Juniperus communis L
甘草提取物(粉)	Licorice extract powder|Glycyrrhiza glabra L
甜菜碱(天然提取)	Betaine (Natural Extract)
松焦油	Pine tar oil|Pinus spp
橡苔净油	Oakmoss absolute|Evernia spp
苏格兰留兰香油	Scotch spearmint oil|Mentha cardiaca L
海索草提取物(又名神香草提取物)	Hyssop extract|Hyssopus officinalis L
安古树皮提取物	Angostura extract|Galipea offincinalis Hancock
德国春黄菊花(母菊花)提取物	Chamomile (German) extract|Matricaria chamomilla L
石榴果汁浓缩物	Pomegranate concentrate
L-苏氨酸	L-Threonine
L-丝氨酸	L-Serine
灵猫净油	Civet absolute|Viverra civetta SchreberV.zibetha Schreber
胭脂树提取物	Annatto extract|Bixa orellana L
卡黎皮提取物	Cascarilla bark extract|Croton spp
肉桂皮油/油树脂	Cinnanon bark oil/oleoresin|Cinnamomaum spp
刺梧桐树胶	Karaya gum|Sterculia urens
橘叶油	Petitgrain mandarin oil|Citrus reticulate Blanco var. mandarin
欧洲山松针叶油	Pine needle oil,dwarf,oil|Pinus mugo turra var. Pumilio (Haenke) Zenari
玫瑰果籽提取物	Rose hips extract|Rosa spp
夏香草油	Savory summer oil|Satureja hortensis L
加拿大细辛油	Snakeroot oil,Canadian|Asarum canadense L
单宁酸	Tannic acid
黄蓍胶	Tragacanth gum|Astragalus spp
甘牛至油树脂/提取物	Marjoram oleoresin/extract|Majorana hortensis Moench (Origanum majorana L.)
摩洛哥豆蔻提取物	Grains of paradise extract|A framomum melegueta (Rosc.) K.Schum
橙皮素	Hesperetin
根皮素	Phloretin
芝麻(CO2)提取物		Sesame CO2 extract
芝麻蒸馏物	Sesame dist
干制鲣鱼(CO2)提取物		Katsuobushi CO2 extract
郎姆酒净油	Rum absolute
豆豉油树脂	Toushi oleoresin|Douchioleoresin
药蜀葵	Althea root|Althea officinalis L
香蜂草	Balm|Melissa officinalis L
白千层油	Cajeput oil|Melaleuca cajuputi Powell
玉米穗丝	Corn silk|Zea mays L
毕澄茄	Cubebs|Piper cubeba L.f
芦荟提取物	Aloe extract|Aloe spp
龙涎香酊	Ambergris tincture
黄葵酊	Ambrette tincture|Hibiscus abelmoschus L
燕根(萝藦科植物)提取物	Swallowroot (Decalepis hamiltonii) extract
红枣浸膏	Date concrete|Ziziphus jujuba
高倍天然苹果香料	Folded Apple Essence
β - 愈疮木烯	β -Guaiene 
　　　　　　Guaia-1 (5),7 (11)-diene
褐藻胶	Algin|Laminaria spp,and other kelps
香厚壳桂皮油	Massoia bark oil|Cryptocarya massoio
(-)-高圣草酚钠盐	(-)-Homoeriodyctiol sodium salt
酶处理异槲皮苷	Isoquercitrin,enzymatically modified
葡萄籽提取物	Grape seed extract|Vitis vinifera
留兰香提取物	Spearmint extract|Mentha spicata L
杂醇油(精制过)	Fusel oil,refined


术语类型：食品用合成香料

丙二醇	1,2-Propanediol|Propylene glycol
甘油|丙三醇	Glycerine|Glycerol
异丙醇	Isopropyl alcohol
正丁醇	1-Butanol|Butyl alcohol
异丁醇	Isobutyl alcohol
正戊醇	1-Pentanol|Amyl alcohol
2-戊醇 2-Pentanol
异戊醇	Isoamyl alcohol
1-戊烯-3-醇 1-Penten-3-ol
正己醇	1-Hexanol|Hexyl alcohol
2-己烯-1-醇	2-Hexen-1-ol
4-己烯-1-醇	4-Hexen-1-ol
正庚醇	1-Heptanol|Heptyl alcohol
正辛醇	1-Octanol|Octyl alcohol
2-辛醇	2-Octanol
1-辛烯-3-醇	1-Octen-3-ol
顺式-5-辛烯-1-醇	cis-5-Octen-1-ol
正壬醇	1-Nonanol|Nonyl alcohol
顺式-6-壬烯-1-醇	cis-6-Nonen-1-ol
反式-2-壬烯-1-醇	trans-2-Nonen-1-ol
2,6-壬二烯-1-醇	2,6-Nonadien-1-ol
正癸醇	1-Decanol|Decyl alcohol
十一醇	Undecyl alcohol
月桂醇(十二醇)	Lauryl alcohol|Dodecyl alcohol
1-十六醇		1-Hexadecanol
小茴香醇	Fenchyl alcohol
叶醇|顺式-3-己烯-1-醇		Leaf alcohol|cis-3-Hexen-1-ol
龙脑	Borneol
芳樟醇	Linalool
氧化芳樟醇	Linalool oxide
异胡薄荷醇	Isopulegol
苏合香醇|α-甲基苄醇	Styralyl alcohol|α-Methylbenzyl alcohol
苯甲醇	Benzyl alcohol
苯乙醇	Phenethyl alcohol
苯丙醇	Phenylpropyl alcohol 
玫瑰醇	Rhodinol
α-松油醇	α-Terpineol
金合欢醇	Farnesol
香叶醇	Geraniol
dl-香茅醇	dl-Citronellol
茴香醇	Anisyl alcohol
肉桂醇	Cinnamic alcohol
α-紫罗兰醇|甲位紫罗兰醇	α-Ionol
β-紫罗兰醇|又名乙位紫罗兰醇 	β-Ionol
二氢-β-紫罗兰醇	Dihydro-β-ionol
橙花醇	Nerol
橙花叔醇	Nerolidol
二甲基苄基原醇	Dimethyl benzyl carbinol
正丙醇	1-Propanol|Propyl alcohol
3-己醇	3-Hexanol
1-己烯-3-醇		1-Hexen-3-ol
2-乙基己醇	2-Ethyl-1-hexanol
2-庚醇	2-Heptanol
3-辛醇	3-Octanol
顺式-3-辛烯-1-醇	cis-3-Octen-1-ol
2-十一醇		2-Undecanol
对,α -二甲基苄醇		p,α -Dimethylbenzyl alcohol
对-异丙基苄醇	p-Isopropylbenzyl alcohol
对,α,α-三甲基苄醇		p,α,α -Trimethylbenzyl alcohol
β-石竹烯醇	β -Caryophyllene alcohol
龙蒿脑	Estragole
四氢香叶醇	Tetrahydrogeraniol 	
二氢香芹醇	Dihydrocarveol
1-对-?-4-醇|1-对-薄荷烯-4-醇	1-p-Menthen-4-ol 
紫苏醇	Perilla alcohol
薄荷脑(dl-薄荷脑, l-薄荷脑) 	Menthol (dl-Menthol,l-Menthol)
3-(l -薄荷烷氧基) -2-甲基-1,2-丙二醇	3-( l-Menthoxy)-2-methylpropane-1,2-diol
3,5,5-三甲基环己醇		3,5,5-Trimethylcyclohexanol
顺式-2-壬烯-1-醇	cis-2-Nonen-1-ol
反式,反式-2,4- 癸二烯醇	(E,E)-2,4-Decadien-1-ol|trans, trans-2,4-Decadien-1-ol
反式-2-辛烯-4-醇	(E)-2-Octen-4-ol
对-?-3-烯-1-醇|对-3-薄荷烯-1-醇		p-Menth-3-en-1-ol
对-?-1,8(10)二烯-9-醇|对-1,8(10)薄荷二烯-9-醇	Menthadienol|p-mentha-1,8(10)-dien-9-ol
柏木烯醇	Cedrenol
脱氢芳樟醇	Dehydrolinalool|(E)-3,7-Dimethyl-1,5,7-octatrien-3-ol
d-木糖	d-Xylose
d-核糖	d -Ribose
l-鼠李糖	l-Rhamnose
二苯醚	Diphenyl ether
对-甲酚甲醚	p-Cresyl methyl ether
异丁香酚甲醚	Isoeugenyl methyl ether
甲基苯乙醚	Methyl phenethyl ether
朗姆醚|乙醇氧化水合物	Rum ether|Ethyl oxyhydrate
仲丁基乙醚	sec-Butyl ethyl ether
乙基苄基醚	Ethyl benzyl ether
大茴香醚	Anisole
邻-甲基大茴香醚	o-Methylanisole
橙花醚	Nerol oxide 
2,4-二甲基大茴香醚	2,4-Dimethylanisole
香兰基乙醚	Vanillyl ethyl ether
丁香酚	Eugenol
异丁香酚	Isoeugenol
甲基丁香酚	Methyl eugenol
对-甲酚	p-Cresol
邻-甲酚	o-Cresol
间-甲酚	m-Cresol
百里香酚	Thymol
麦芽酚	Maltol
苯酚	Phenol
2-甲氧基-4-甲基苯酚	2-Methoxy-4-methylphenol
对-乙基苯酚	p -Ethylphenol
2-甲氧基-4-乙烯基苯酚	2-Methoxy-4-vinylphenol
对-二甲氧基苯	p -Dimethoxybenzene
愈疮木酚	Guaiacol
4-乙基愈疮木酚	4-Ethylguaiacol
苯甲醛丙二醇缩醛	Benzaldehyde propylene glycol acetal
2-异丙基苯酚	2-Isopropylphenol
2,6-二甲基苯酚	2,6-Xylenol
2,6-二甲氧基苯酚	2,6-Dimethoxyphenol
间苯二酚	Resorcinol
香芹酚	Carvacrol
2-甲氧基-4-丙基苯酚	2-Methoxy-4-propylphenol
2,5-二甲基苯酚	2,5-Xylenol
对-乙烯基苯酚	p -Vinylphenol
乙醛	Acetaldehyde
乙醛二乙缩醛	Acetaldehy dediethyl acetal
丙醛	Propionaldehyde
3-(2-呋喃基)丙烯醛	3-(2-Furyl)acrolein
丁醛	Butyraldehyde
2-甲基丁醛	2-Methylbutyraldehyde
2-甲基-2-丁烯醛	2-Methyl-2-butenal
2-苯基-2-丁烯醛	2-Phenyl-2-butenal
戊醛	Valeraldehyde
异戊醛	Isovaleraldehyde
2-甲基戊醛	2-Methylvaleraldehyde
2-戊烯醛	2-Pentenal
2-甲基-2-戊烯醛	2-Methyl-2-pentenal
4-甲基-2-苯基-2-戊烯醛	4-Methyl-2-phenyl-2-pentenal
2,4-戊二烯醛	2,4-Pentadienal
己醛	Hexanal
2-己烯醛(又名叶醛)	2-Hexenal(Leafaldehyde)
顺式-3-己烯醛	cis-3-Hexenal
5-甲基-2-苯基-2-己烯醛	5-Methyl-2-phenyl-2-hexenal
2-异丙基-5-甲基-2-己烯醛	2-Isopropyl-5-methyl-2-hexenal
反式,反式-2,4-己二烯醛	trans,trans-2,4-Hexadienal
庚醛	Heptylaldehyde
4-庚烯醛	4-Heptenal
反式-2-庚烯醛	trans-2-Heptenal
2,6-二甲基-5-庚烯醛	2,6-Dimethyl-5-heptenal
2,4-庚二烯醛	2,4-Heptadienal
辛醛	Octylaldehyde
2-辛烯醛	2-Octenal
反式,反式-2,4-辛二烯醛	trans,trans-2,4-Octadienal
反式,反式-2,6-辛二烯醛	trans , trans -2 , 6-Octadienal
壬醛	Nonanal
甲基壬乙醛|2-甲基十一醛	Methylnonylacetaldehyde|2-Methylundecanal
2-壬烯醛	2-Nonenal
顺式-6-壬烯醛	cis-6-Nonenal
2,4-壬二烯醛|反式-2-反式-4-壬二烯醛	2,4-Nonadienal|trans-2-trans-4-Nonadienal
反式-2-顺式-6-壬二烯醛	Nona-2-trans-6-cis-dienal
甲酸桃金娘烯酯	Myrtenyl formate
正癸醛|癸醛	n-Decyl aldehyde|Decanal
2-癸烯醛	2-Decenal
2,4-癸二烯醛	2,4-Decadienal
十一醛	Undecanal
2-十一烯醛	2-Undecenal
2,4-十一碳二烯醛	2,4-Undecadienal
月桂醛	Lauric aldehyde
2-十二碳烯醛	2-Dodecenal
反式-2-顺式-6-十二碳二烯醛	2-trans-6-cis -Dodecadienal
十四醛	Tetradecylaldehyde
桃醛|γ-十一烷内酯	Peach aldehyde|γ-Undecalactone
大茴香醛	p-Anisaldehyde
水杨醛	Salicylaldehyde
苯甲醛	Benzaldehyde
甲基苯甲醛|邻、对、间位混合物	Tolualdehydes|mixed o,m,p 
3,4-二甲氧基苯甲醛	3,4-Dimethoxybenzenecarbonal
苯乙醛	Phenylacetaldehyde
苯乙醛二甲缩醛	Phenylacetaldehy dedimethyl acetal
苯丙醛|3-苯基丙醛	Phenylpropyl aldehyde|3-Phenylpropional-dehyde
枯茗醛	Cuminaldehyde
香兰素	Vanillin
香茅醛	Citronellal
柠檬醛	Citral
洋茉莉醛|胡椒醛	Heliotropin|Piperonal
肉桂醛	Cinnamic aldehyde
乙二醇缩肉桂醛	Cinnamaldehyde ethylene glycol acetal
紫苏醛	Perillaldehyde
对-?-1-烯-9-醛|对-1-薄荷烯-9-醛		p-Menth-1-en-9-al
糠醛	Furfural
5-甲基糠醛	5-Methylfurfural
1,1-二甲氧基乙烷	1,1-Dimethoxyethane
2,6,6-三甲基环己-1,3-二烯基甲醛		2,6,6-Trimethylcyclohexa-1,3-dienyl-methanal
异丁醛	Isobutyraldehyde
顺式-4-己烯醛	cis-4-Hexenal
顺式-5-辛烯醛	cis-5-Octenal
4-癸烯醛	4-Decenal
反式,反式-2,4-十二碳二烯醛	trans,trans-2,4-Dodecadienal
2-十三烯醛	2-Tridecenal
4-乙基苯甲醛	4-Ethylbenzaldehyde
2-羟基-4-甲基苯甲醛	2-Hydroxy-4-methylbenzaldehyde
邻-甲氧基肉桂醛	o-Methoxycinnamaldehyde
龙脑烯醛	Campholenic aldehyde
α-己基肉桂醛	α-Hexylcinnamaldehyde
香兰素1,2-丙二醇缩醛		Vanillinpropyleneglycolacetal
乙醛乙醇顺式-3-己烯醇缩醛	Acetaldehyde ethyl cis-hexenyl acetal
反式,反式-2,6-壬二烯醛	2-trans-6-trans-Nonadienal
2,4,7-癸三烯醛	2,4,7-Decatrienal
β-甜橙醛	β-Sinensal
4-羟基苯甲醛	4-Hydroxy benzaldehyde
邻-甲氧基苯甲醛	o-Methoxybenzaldehyde
12-甲基十三醛	12-Methyltridecanal
甲乙酮	Methylethylketone
3-羟基-2-丁酮|乙偶姻	3-Hydroxy-2-butanone|Acetoin
4-(对-甲氧基苯基)-2-丁酮	4-(p-Methoxyphenyl)-2-butanone
4-苯基-3-丁烯-2-酮	4-Phenyl-3-buten-2-one
丁二酮	Diacetyl
2,3-丁二酮	2,3-Diketobutane
2-戊酮	2-Pentanone
1-戊烯-3-酮	1-Penten-3-one 3382
2,3-戊二酮	2,3-Pentanedione
3-乙基-2-羟基-2-环戊烯-1-酮	3-Ethyl-2-hydroxy-2-cyclopenten-1-one
甲基环戊烯醇酮|3-甲基-2-羟基-2-环戊烯-1-酮	Methylcyclopentenolone|3-methyl-2-hydroxy-2-cyclopenten-1-one
4-己烯-3-酮	4-Hexene-3-one
5-甲基-3-己烯-2-酮	5-Methyl-3-hexen-2-one
3,4-己二酮	3,4-Hexanedione
2-庚酮	2-Heptanone
3-庚烯-2-酮	3-Hepten-2-one|Methylpentenylketone
6-甲基-5-庚烯-2-酮	6-Methyl-5-hepten-2-one
1-辛烯-3-酮	1-Octen-3-one
2-壬酮	2-Nonanone
2-十一酮	2-Undecanone
2-十三酮	2-Tridecanone
圆柚酮	Nootkatone
l-香芹酮	l-Carvone
苯乙酮	Acetophenone
4-甲基苯乙酮	4-Methylacetophenone
对-甲基苯乙酮	p -Methylacetophenone
对-甲氧基苯乙酮	p-Methoxyacetophenone
顺式茉莉酮	cis-Jasmone
覆盆子酮|悬钩子酮	Raspberryketone|4-(p-Hydroxyphenyl)-2-butanone
α-突厥酮	α-Damascone
突厥烯酮	Damascenone
苯甲醛甘油缩醛	Benzaldehyde glyceryl acetal
α-鸢尾酮	α-Irone
α-紫罗兰酮	α-Ionone
β-紫罗兰酮	β-Ionone
dl-樟脑	dl-Camphor
薄荷酮	Menthone
d,l-异薄荷酮	d,l -Isomenthone
4-(2-呋喃基)-3-丁烯-2-酮	4-(2-Furyl)-3-buten-2-one
2-乙基-4-羟基-5-甲基-3(2H)-呋喃酮	2-Ethyl-4-hydroxy-5-methyl-3(2H)-furanone 
4,5-二甲基-3-羟基-2,5-二氢呋喃-2-酮	4,5-Dimethyl-3-hydroxy-2,5-dihydrofuran-2-one
2-乙基-3-甲基-4-羟基二氢-2,5-呋喃-5-酮	2-Ethyl-3-methyl-4-hydroxydihydro-2,5-furan-5-one
4,5-二氢-3(2H)-噻吩酮(四氢噻吩-3-酮)	4,5-Dihydro-3-(2H)-thiophenone(Tetra-hydrothiophen-3-one)
2-乙基呋喃	2-Ethylfuran
2-乙酰基呋喃	2-Acetylfuran
2-乙酰基-5-甲基呋喃	2-Acetyl-5-methylfuran
丙酮	Acetone
1-苯基-1,2-丙二酮	1-Phenyl-1,2-propanedione
3,4-二甲基-1,2-环戊二酮	3,4-Dimethyl-1,2-cyclopentadione
3,5-二甲基-1,2-环戊二酮	3,5-Dimethyl-1,2-cyclopentadione
2,3-己二酮	2,3-Hexanedione
1-甲基-2,3-环己二酮	1-Methyl-2,3-cyclohexadione
2,2,6-三甲基环己酮	2,2,6-Trimethylcyclohexanone
2,6,6-三甲基-2-环己烯-1,4-二酮	2,6,6-Trimethylcyclohex-2-ene-1,4-dione
3-庚酮	3-Heptanone
5-甲基-2-庚烯-4-酮	5-Methyl-2-hepten-4-one
6-甲基-3,5-庚二烯-2-酮	6-Methyl-3,5-heptadien-2-one
2-辛酮	2-Octanone
3-辛酮	3-Octanone
3-辛烯-2-酮	3-Octen-2-one
6,10-二甲基-5,9-十一碳二烯-2-酮	6,10-Dimethyl-5,9-undecadien-2-one
2-十五酮	2-Pentadecanone
3-甲基环十五酮	3-Methyl-1-cyclopentadecanone
环十七-9-烯-1-酮	Cycloheptadeca-9-en-1-one
二苯甲酮	Benzophenone
2-羟基苯乙酮	2-Hydroxyacetophenone
异弗尔酮	Isophorone
二氢茉莉酮|2-戊基-3-甲基-2-环戊烯-1-酮	Dihydrojasmone|2-Pentyl-3-methyl-2-cyclo-penten-1-one
新甲基橙皮苷二氢查耳酮	Neohesperi dindihydrochalcone|Neohesperidin DHC
姜油酮	Zingerone
β-突厥酮|4-(2,6,6-三甲基环己-1-烯基)丁-2-烯-4-酮	β-Damascone|4-(2,6,6-Trimethylcyclohex-1-enyl)but-2-en-4-one
3-甲硫基丁醛	3-(Methylthio)butanal
α-戊基肉桂醛	α-Amylcinnamaldehyde
d - 葑酮	d -Fenchone
2-甲基四氢呋喃-3-酮	2-Methyltetrahydrofuran-3-one
4-羟基-2,5-二甲基-3(2H)-呋喃酮	4-Hydroxy-2,5-dimethyl-3(2H)-furanone
2,5-二甲基-4-甲氧基-3(2H)-呋喃酮	2,5-Dimethyl-4-methoxy-3(2H)-furanone
2-戊基呋喃	2-Pentylfuran
4,5,6,7-四氢-3,6-二甲基苯并呋喃|薄荷呋喃	4,5,6,7-Tetrahydro-3,6-dimethylbenzofuran|Menthofuran
1,5,5,9-四甲基-13-氧杂三环[8.3.0.0(4,9)]十三烷	1,5,5,9-Tetramethyl-13-oxatricyclo[8.3.0.0(4,9)]tridecane
顺式-二氢香芹酮	cis-Dihydrocarvone
3-巯基-2-丁酮|3-巯基-丁-2-酮	3-Mercapto-2-butanone
胡椒基丙酮	Piperonyl acetone
二氢-β-紫罗兰酮	Dihydro-β-ionone
4-甲基-2,3-戊二酮	4-Methyl-2,3-pentanedione
反式-7-甲基-3-辛烯-2-酮	(E)-7-Methyl-3-octen-2-one
3-乙酰硫基-2-甲基呋喃	3- (Acetylthio)-2-methylfuran
4-乙酰氧基-2,5-二甲基-3(2H)-呋喃酮	4-Acetoxy-2,5-dimethyl-3(2H)-furanone
3-乙基-2-羟基-4-甲基-2-环戊烯-1-酮	3-Ethyl-2-hydroxy-4-methylcyclopent-2-en-1-one
环己酮	Cyclohexanone
2,3-庚二酮	2,3-Heptanedione
2,3-辛二酮	2,3-Octanedione
乙酸	Acetic acid
丙酸	Propionic acid
丙酮酸	Pyruvic acid
丁酸	Butyric acid
异丁酸	Isobutyric acid
2-甲基丁酸	2-Methylbutyric acid
2-乙基丁酸	2-Ethylbutyric acid
戊酸	Valeric acid
2-甲基戊酸	2-Methylvaleric acid
2-甲基-2-戊烯酸|草莓酸	2-Methyl-2-pentenoic acid|Strawberriff
异戊酸	Isovaleric acid
己酸	Hexanoic acid
己二酸	Adipic acid
反式-2-己烯酸	trans -2-Hexenoic acid
3-己烯酸	3-Hexenoic acid
庚酸	Heptanoic acid
辛酸	Octanoic acid
壬酸	Nonoic acid
癸酸	Decanoic acid
十二酸|月桂酸	Dodecanoic acid|Lauric acid
十四酸|肉豆蔻酸	Tetradecanoic acid|Myristic acid
十六酸|棕榈酸	Hexadecylic acid|Palmitic acid
苯甲酸	Benzoic acid
苯乙酸	Phenylacetic acid
柠檬酸	Citric acid
肉桂酸	Cinnamic acid
富马酸	Fumaric acid
3-甲基戊酸|酐酪酸	3-Methylpentanoic acid
β-丙氨酸	β-Alanine
L-苯基丙氨酸	L-Phenylalanine
L-半胱氨酸	L-Cysteine
甘氨酸	Glycine
L-谷氨酸	L-Glutamic acid
L-亮氨酸	L-Leucine
DL-蛋氨酸	DL-Methionine
乙酰丙酸	Levulinic acid
2-氧代丁酸	2-Oxobutyric acid
2-甲基己酸2-Methylhexanoic acid
2-甲基庚酸	2-Methyloenanthic acid
4-甲基辛酸	4-Methyloctanoic acid
3,7-二甲基-6-辛烯酸	3,7-Dimethyl-6-octenoic acid
9-癸烯酸	9-Decenoic acid
十一酸	Undecanoic acid
10-十一碳烯酸 10-Undecenoic acid
3-苯丙酸	3-Phenylpropionic acid
乳酸	Lactic acid
L-脯氨酸	L-Proline
DL-缬氨酸	DL-Valine
2-(4-甲氧基苯氧基)-丙酸钠	Sodium 2-(4-methyoxy-phenoxy)propanoate
L-和DL-丙氨酸	L-and DL-Alanine
L-精氨酸	L-Arginine
L-赖氨酸	L-Lysine
3-甲基巴豆酸	3-Methylcrotonic acid
甲酸	Formic acid
4-甲基壬酸	4-Methylnonanoic acid
异己酸	Isohexanoic acid
2-羟基苯甲酸|水杨酸	2-Hydroxybenzoic acid|Salicylic acid
惕各酸	Tiglic acid
琥珀酸	Succinic acid
硬脂酸	Stearic acid
甲酸乙酯	Ethyl formate
甲酸丁酯	Butyl formate
甲酸戊酯	Amyl formate
甲酸异戊酯	Isoamyl formate
甲酸己酯	Hexyl formate
甲酸苄酯	Benzyl formate
甲酸香叶酯	Geranyl formate
甲酸香茅酯	Citronellyl formate
甲酸苯乙酯	Phenethyl formate
甲酸芳樟酯	Linalyl formate
乙酸甲酯	Methyl acetate
乙酸乙酯	Ethyl acetate
乙酰乙酸乙酯	Ethyl acetoacetate
乙酸丙酯	Propyl acetate
乙酸异丙酯	Isopropyl acetate
乙酸烯丙酯	Allyl acetate
乙酰丙酸乙酯	Ethyl acetylpropanoate
乙酸丁酯	Butyl acetate
乙酸异丁酯	Isobutyl acetate
乙酸异戊酯	Isoamyl acetate
乙酸己酯	Hexyl acetate
乙酸 2-己烯酯	2-Hexen-1-ylacetate
乙酸庚酯	Heptyl acetate
乙酸辛酯	Octyl acetate
乙酸 3-辛酯	3-Octyl acetate
1-辛烯-3-醇乙酸酯	1-Octen-3-yl acetate
乙酸壬酯	Nonyl acetate
2-丁烯酸己酯 n–Hexyl 2-butenoate
乙酸癸酯	Decyl acetate
乙酸苄酯	Benzyl acetate
乙酸苯乙酯	Phenethyl acetate
乙酸茴香酯	Anisyl acetate
乙酸龙脑酯	Bornyl acetate
乙酸薄荷酯	Menthol acetate
乙酸肉桂酯	Cinnamyl acetate
乙酸香茅酯	Citronellyl acetate
乙酸香叶酯	Geranyl acetate
乙酸对-甲酚酯	p-Cresyl acetate
乙酸苏合香酯	Styrallyl acetate 
乙酸橙花酯	Neryl acetate
乙酸松油酯	Terpinyl acetate
异丁酸肉桂酯	Cinnamyl isobutyrate
顺式-3-己烯-1-醇乙酸酯|乙酸叶醇酯	cis-3-Hexen-1-yl acetate|Leaf acetate 
乙酸糠酯	Furfuryl acetate
庚酸烯丙酯	Allyl heptanoate
乙酸芳樟酯	Linalyl acetate
乙酸葛缕酯	Carvyl acetate
乙酸二氢葛缕酯	Dihydrocarvyl acetate
苯乙酸丁酯	Butyl phenylacetate
丙酸乙酯	Ethyl propionate
丙二酸二乙酯	Diethyl malonate
丙酸异丁酯	Isobutyl propionate
丙酸异戊酯	Isoamyl propionate
丙酸顺式-3-己烯酯和丙酸反式-2-己烯酯	cis-3-Hexenyl propionate and trans-2-Hexenyl propionate
丙酸香叶酯	Geranyl propiona
丙酸香茅酯	Citronellyl propionate
丙酸苄酯	Benzyl propionate
丙酸苯乙酯	Phenethyl propionate
丙酸芳樟酯	Linalyl propionate
丁酸甲酯	Methyl butyrate
2-甲基丁酸甲酯	Methyl 2-methylbutyrate
丁酸乙酯	Ethyl butyrate
异丁酸乙酯	Ethyl isobutyrate
2-甲基丁酸乙酯	Ethyl 2-methylbutyrate
3-羟基丁酸乙酯	Ethyl 3-hydroxybutyrate
丁二酸二乙酯	Diethyl succinate
异丁酸甲酯	Methyl isobutyrate
丁酸丁酯	Butyl butyrate
丁酸异丁酯	Isobutyl butyrate
2-甲基丁酸丁酯	n-Butyl 2-methylbutyrate
2-甲基丁酸 2-甲基丁酯	2-Methylbutyl 2-methylbutyrate
异丁酸丁酯	Butyl isobutyrate
丁酸戊酯	Amyl butyrate
丁酸异戊酯	Isoamyl butyrate
2-甲基丁酸异戊酯	Isoamyl 2-methylbutanoate
异丁酸异戊酯	Isopentyl isobutyrate
丁酸己酯	Hexyl butyrate
2-甲基丁酸己酯	Hexyl 2-methylbutyrate
丁酸顺式-3-己烯酯|丁酸叶醇酯	cis-3-Hexenyl butyrate|Leafbutyrate
2-甲基丁酸-3-己烯酯	3-Hexenyl 2-methylbutanoate
异丁酸庚酯	Heptyl isobutyrate
2-甲基丁酸辛酯	Octyl 2-methylbutyrate
1-辛烯-3-醇丁酸酯	1-Octen-3-yl butyrate
丁酸苄酯	Benzyl butyrate
异丁酸苄酯	Benzyl isobutyrate
丁酸苯乙酯	Phenethyl butyrate
2-甲基丁酸苯乙酯	Phenethyl 2-methylbutyrate
异丁酸苯乙酯	Phenethyl isobutyrate
丁酸香叶酯	Geranyl butyrate
异丁酸香叶酯	Geranyl isobutyrate
丁酸芳樟酯	Linalyl butyrate
异丁酸芳樟酯	Linalyl isobutyrate
当归酸异丁酯	Isobutyl angelate
异丁酸橙花酯	Neryl isobutyrate
正戊酸乙酯	Ethyl valerate
丁酰乳酸丁酯	Butyl butyryllactate
异戊酸乙酯	Ethyl isovalerate
水杨酸丁酯|柳酸丁酯	Butyl salicylate
异戊酸丁酯	Butyl isovalerate
异戊酸异戊酯	Isoamyl isovalerate
异戊酸 3-己烯酯	3-Hexenyl isovalerate
异戊酸壬酯	Nonyl isovalerate
异戊酸苯乙酯	Phenethyl isovalerate
异戊酸香叶酯	Geranyl isovalerate
己酸甲酯	Methyl hexanoate
2-己烯酸甲酯	Methyl 2-hexenoate
己酸乙酯	Ethyl hexanoate(Ethylcaproate)
3-己烯酸乙酯	Ethyl 3-hexenoate
3-羟基己酸乙酯	Ethyl 3-hydroxyhexanoate
反式-2-己烯酸乙酯	Ethyl trans-2-hexenoate
己酸丙酯	Propyl hexanoate
己酸戊酯	Amyl hexanoate
己酸异戊酯	Isoamyl hexanoate
己酸己酯	Hexyl hexanoate
己酸顺式-3-己烯酯|己酸叶醇酯	cis-3-Hexenylhexanoate |Leaf hexanoate
庚酸乙酯	Ethyl heptanoate
庚酸丙酯	Propyl heptanoate
庚酸丁酯	Butyl heptanoate
2-甲基-3-巯基呋喃	2-Methyl-3-furanthiol
辛酸甲酯	Methyl caprylate
辛酸乙酯	Ethyl caprylate
顺式-4-辛烯酸乙酯	Ethyl cis-4-octenoate
顺式-4,7-辛二烯酸乙酯	Ethyl cis-4,7-octadienoate
辛酸异戊酯	Isoamyl octanoate
辛酸壬酯	Nonyl octanoate
辛酸苯乙酯	Phenethyl octanoate
2-壬烯酸甲酯	Methyl 2-nonenoate
壬酸乙酯
Ethyl nonanoate
癸酸乙酯	Ethyl decanoate
反式-2-顺式-4-癸二烯酸乙酯	Ethyl trans-2,cis-4-decadienoate
十二酸乙酯|月桂酸乙酯	Ethyl dodecanoate|Ethyl laurate
十四酸甲酯|肉豆蔻酸甲酯	Methyl tetradecanoate|Methtyl myristate
苯甲酸甲酯	Methyl benzoate
苯甲酸乙酯	Ethyl benzoate
苯甲酸丙酯	Propyl benzoate
苯甲酸己酯	Hexyl benzoate
苯甲酸苄酯	Benzyl benzoate
苯甲酸顺式-3-己烯酯|苯甲酸叶醇酯	cis-3-Hexenyl benzoate|Leaf benzoate
邻氨基苯甲酸甲酯	Methyl anthranilate
苯乙酸甲酯	Methyl phenylacetate
苯乙酸乙酯	Ethyl phenylacetate
苯乙酸异戊酯	Isoamyl phenylacetate
苯乙酸苯乙酯	Phenethyl phenylacetate
惕各酸乙酯	Ethyl tiglate
惕各酸苄酯	Benzyl tiglate
乳酸乙酯	Ethyl lactate
乳酸丁酯	Butyl lactate
肉桂酸甲酯	Methyl cinnamate
肉桂酸乙酯	Ethyl cinnamate
肉桂酸苄酯	Benzyl cinnamate
肉桂酸苯乙酯	Phenethyl cinnamate
肉桂酸肉桂酯	Cinnamyl cinnamate
水杨酸甲酯|柳酸甲酯	Methyl salicylate
水杨酸乙酯|柳酸乙酯	Ethyl salicylate
水杨酸异戊酯|柳酸异戊酯	Isoamyl salicylate
十四酸乙酯|肉豆蔻酸乙酯	Ethyl tetradecanoate|Ethyl myristate
油酸乙酯	Ethyl oleate
棕榈酸乙酯	Ethyl palmitate
二氢茉莉酮酸甲酯	Methyl dihydrojasmonate
椰子油混合酸乙酯	Ethyl ester of coconut oil mixed acid
柠檬酸三乙酯Triethyl citrate
甲酸大茴香酯	Anisyl formate
甲酸顺式-3-己烯酯|甲酸叶醇酯	cis-3-Hexenyl formate|Leaf formate
乙酸 2-甲基丁酯	2-Methylbutyl acetate
乙酸 3-苯丙酯	3-Phenylpropyl acetate
乙酸丁香酯	Eugenyl acetate
4,5-二甲基-2-异丁基-3-噻唑啉	4,5-Dimethyl-2-isobutyl-3-thiazoline
乙酸异胡薄荷酯	Isopulegyl acetate
乙酸 1,3,3-三甲基-2-降龙脑酯	1,3,3-Trimethyl-2-norbornanyl acetate
丙酸甲酯	Methyl propionate
丙烯酸乙酯	Ethyl acrylate
乳酸顺式-3-己烯酯|乳酸叶醇酯	cis-3-Hexenyl lactate|Leaf lactate
丙酸癸酯	Decyl propionate
反式-2-丁烯酸乙酯	Ethyl trans-2-butenoate
丁酸丙酯	Propyl butyrate
异丁酸异丙酯	Isopropyl isobutyrate
2-甲基丁酸异丙酯	Isopropyl 2-methylbutyrate
异丁酸己酯	Hexyl isobutyrate
丁酸庚酯	Heptyl butyrate
异丁酸辛酯	Octyl isobutyrate
异丁酸-3-苯丙酯	3-Phenylpropyl isobutyrate
丁酸香茅酯	Citronellyl butyrate
丁酸肉桂酯	Cinnamyl butyrate
异戊酸甲酯	Methyl isovalerate
异戊酸异丁酯	Isobutyl isovalerate
异戊酸 2-甲基丁酯	2-Methylbutyl isovalerate
异戊酸苄酯	Benzyl isovalerate
2-戊基吡啶	2-Pentylpyridine
异戊酸肉桂酯	Cinnamyl isovalerate
异戊酸薄荷酯	Menthyl isovalerate
3-己烯酸甲酯	Methyl 3-hexenoate
正己酸异丁酯	Isobutyl caproate
己酸烯丙酯	Allyl hexanoate
己酸芳樟酯	Linalyl hexanoate
3,7-二甲基-6-辛烯酸甲酯	Methyl 3,7-dimethyl-6-octenoate
3-壬烯酸甲酯	Methyl 3-nonenoate
9-十一烯酸甲酯	Methyl 9-undecenoate
十一酸乙酯	Ethyl undecanoate
十四酸异丙酯|肉豆蔻酸异丙酯	Isopropyl tetradecanoate|Isopropyl myristate
N-甲基邻氨基苯甲酸甲酯	Methyl N-methylanthranilate(Dimethylan-thranilate)
邻氨基苯甲酸乙酯	Ethyl anthranilate
苯甲酸异戊酯	Isoamyl benzoate
苯甲酸苯乙酯	Phenethyl benzoate
苯乙酸异丁酯	Isobutyl phenylacetate
苯乙酸己酯	Hexyl phenylacetate
苯丙酸乙酯|氢化肉桂酸乙酯	Ethyl 3-phenylpropionate|Ethylhydrocin-namate
环己基羧酸甲酯	Methyl cyclohexanecarboxylate
大茴香酸甲酯	Methyl p-anisate
大茴香酸乙酯	Ethyl p-anisate
水杨酸苯乙酯	Phenethyl salicylate
十二酸异戊酯|月桂酸异戊酯	Isoamyl dodecanoate|Isoamyl laurate
亚油酸甲酯(48%),亚麻酸甲酯(52%)混合物		Methyl linoleate(48%),methyl linolenate(52%)mixture
茉莉酮酸甲酯	Methyl jasmonate
水杨酸苄酯|柳酸苄酯	Benzyl salicylate
肉桂酸异丁酯	Isobutyl cinnamate
肉桂酸 3-苯丙酯	3-Phenylpropyl cinnamate
酒石酸二乙酯	Diethyl tartrate
菸酸甲酯	Methyl nicotinate
惕各酸苯乙酯	Phenethyl tiglate
3-乙酰基-2,5-二甲基噻吩	3-Acetyl-2,5-dimethylthiophene
3,5,5-三甲基-1-己醇	3,5,5-Trimethyl-1-hexanol
丁酸茴香酯	Anisyl butyrate
异戊酸龙脑酯	Bornyl isovalerate
2,6-二甲基-4-庚醇	2,6-Dimethyl-4-heptanol
苯甲酸异丁酯	Isobutyl benzoate
甲酸橙花酯	Neryl formate
乙酸甲基苄醇酯(邻、间、对位混合物)		Methylbenzyl acetate(mixed o-,m-,p-)
乙酸顺式和反式-对1,(7)8-二烯-2-醇酯|乙酸顺式和反式-对1,(7)8-薄荷二烯-2-醇酯	cis-and-trans-p-1,(7)8-Menthadien-2-ylace-tate
乙酸龙脑烯醇酯	Campholene acetate
丙酸丙酯	Propyl propionate
丙酸丁酯	Butyl propionate
丙酸己酯	Hexyl propionate
丙酮酸乙酯	Ethyl pyruvate
丁酸辛酯	Octyl butyrate
异丁酸丙酯	n-Propyl isobutyrate
异丁酸异丁酯	Isobutyl isobutyrate
异丁酸香茅酯	Citronellyl isobutyrate
反式-2-丁烯酸顺式-3-己烯酯|反式-2-丁烯酸叶醇酯	(Z)-3-Hexenyl(E)-2-butenoate|Leaf(E)-2-butenoate
丁二酸单薄荷酯|琥珀酸单薄荷酯	Diethyl butanedioate|Momo-menthyl succi-nate
正戊酸正戊酯	Pentyl valerate
异戊酸辛酯	Octyl isovalerate
己酸丁酯	Butyl hexanoate
己酸苯乙酯	Phenethyl hexanoate
异丁酸叶醇酯|顺式-3-己烯醇异丁酸酯
Leaf isobutyrate|(Z)-3-Hexenyl isobu-tyrate
辛酸己酯	Hexyl octanoate
2-辛烯酸乙酯	Ethyl 2-octenoate
2,4,7-癸三烯酸乙酯	Ethyl 2,4,7-decatrienoate
苯甲酸芳樟酯	Linalyl benzoate
反式-2-甲基2-丁烯酸顺式-3-己烯酯|惕各酸叶醇酯	(Z)-3-Hexenyl (E)-2-methyl2-butenoate|Leaftiglate
2-丁烯酸异丁酯	Isobutyl 2-butenoate
3-甲基丁酸己酯	Hexyl 3-methyl butanoate
顺式-3-己烯酸顺式-3-己烯酯|顺式-3-己烯酸叶醇酯	cis-3-Hexenyl cis-3-hexenoate|Leaf cis-3-hexenoate
3-羟基己酸甲酯	Methyl 3-hydroxyhexanoate
苯甲酸香叶酯	Geranyl benzoate
琥珀酸二甲酯	Dimethyl succinat
硬脂酸乙酯	Ethyl stearate
3-甲基-2-丁烯-1-醇乙酸酯|乙酸异戊烯酯		3-Methyl-2-buten-1-ol acetate|Prenyl acetate
己酸反式-2-己烯酯	trans-2-Hexenyl hexanoate
甲酸龙脑酯	Bornyl formate
顺式-4-庚烯酸乙酯	Ethyl (Z)-hept-4-enoate
辛酸戊酯	Amyl octanoate 
4-甲基戊酸甲酯	Methyl 4-methylvalerate
乙酸胡椒醛酯	Heliotropin acetate
丙酸肉桂酯	Cinnamyl propionate
异丁酸甲基苯基原酯|异丁酸苏合香酯	Methyl phenyl carbonyl isobutyrate|Styrallyl isobutyrate
异丁酸十二酯	Dodecyl isobutyrate
异丁酸松油酯	Terpinyl isobutyrate
水杨酸异丁酯	Isobutyl salicylate
肉桂酸异戊酯	Isoamyl cinnamate
乙酸异龙脑酯	Isobornyl acetate
γ-戊内酯	γ-Valerolactone
γ-己内酯	γ-Hexalactone
γ-庚内酯	γ-Heptalactone
γ-辛内酯	γ-Octalactone
γ-壬内酯	γ-Nonalactone
γ-癸内酯	γ-Decalactone
γ-十二内酯	γ-Dodecalactone
γ-丁内酯	γ-Butyrolactone
δ-己内酯	δ-Hexalactone
δ-辛内酯	δ-Octalactone
δ-壬内酯	δ-Nonalactone
δ-癸内酯	δ-Decalactone
δ-十一内酯	δ-Undecalacton
δ-十二内酯	δ-Dodecalactone
十五内酯	Pentadecanolide 
5-羟基-2-癸烯酸δ-内酯	5-Hydroxy-2-decenoic acidδ-lactone|Cocolactone
3-丙叉苯酞	3-Propylidenephthalide 
3-丁叉苯酞	3-Butylidenephthalide
薄荷内酯	Mintlactone
δ-十三内酯	δ-Tridecalactone
δ-十四内酯	δ-Tetradecalactone
5-羟基-2,4-癸二烯酸内酯|6-戊基-α-吡喃酮	5-Hydroxy-2,4-decadienoic acid lactone|6-Pentyl-α-pyrone 
5-羟基-7-癸烯酸内酯|茉莉内酯	5-Hydroxy-7-decenoic acid lactone|Jasminel actone
威士忌内酯	Whiskeyl actone 
二氢猕猴桃内酯|(+/-)-2,6,6-三甲基-2-羟基环亚己基乙酸γ-内酯	Dihydroactinidiolide|(+/-)-(2,6,6-Trimethyl-2-hydroxycyclohexylidene) acetic acid γ-lactone
黄葵内酯	Ambrettolide
α-当归内酯	α-Angelical actone
γ-甲基癸内酯	γ-Methyldecalactone
β-石竹烯	β-Caryophyllene
巴伦西亚橘烯	Valencene
月桂烯	Myrcene
d-苧烯	d-Limonene
异松油烯	Terpinolene
罗勒烯	Ocimene
莰烯	Camphene
α-蒎烯	α-Pinene
β-蒎烯	β-Pinene
1,8-桉叶素	1,8-Cineole
1,4-桉叶素	1,4-Cineole
二氢香豆素	Dihydrocoumarin
1,4-二甲基-4-乙酰基-1-环己烯	1,4-Dimethyl-4-acetyl-1-cyclohexene
2-甲酰基-6,6-二甲基双环[3.1.1]庚-2-烯|桃金娘烯醛	2-Formyl-6,6-dimethylbicyclo[3.1.1]-hept-2-ene|Myrtenal
茶螺烷|1-氧杂螺-(4,5)-2,6,10,10-四甲基-6-癸烯	Theaspirane|2,6,10,10-Tetramethyl-1-oxaspiro(4,5)-dec-6-ene
1,3,5-十一碳三烯	1,3,5-Undecatriene
对,α-二甲基苯乙烯	p,α-Dimethylstyrene
α-水芹烯	α-Phellandrene
红没药烯	Bisabolene
γ-松油烯	γ-Terpinene 
6-羟基二氢茶螺烷	6-Hydroxydihydrotheaspirane
1-甲基-3-甲氧基-4-异丙基苯	1-Methyl-3-methoxy-4-isopropylbenzene
间-二甲氧基苯	m-Dimethoxybenzene
对-异丙基甲苯	p-Cymene
3,4-二甲酚	3,4-Dimethylphenol
1-甲基萘	1-Methylnaphthalene
1,2-二甲氧基苯	1,2-Dimethoxybenzene
α-金合欢烯		α-Farnesene
苏合香烯	Styrene
α-松油烯	α-Terpinene
3-蒈烯	3-Carene
聚苧烯	Polylimonene
香菇素	Lenthionine
氧化石竹烯	Caryophylleneoxide
2,4,6-三甲基-1,3,5-三氧杂环己烷|三聚乙醛	2,4,6-Trimethyl-1,3,5-trioxacyclohexane|Paraldehyde
甲硫醇	Methyl mercaptan
3-甲硫基丙醇	3-(Methylthio) propanol
正丁硫醇	1-Butanethiol
2-甲基-1-丁硫醇	2-Methyl-1-butanethiol
3-(甲硫基)-1-己醇	3-(Methylthio)-1-hexanol
1,6-己二硫醇	1,6-Hexanedithiol
糠基硫醇|咖啡醛	Furfuryl mercaptan
二甲基硫醚	Dimethyl sulfide
二甲基二硫醚	Dimethyl disulfide
二甲基三硫醚	Dimethyl trisulfide
二丁基硫醚	Dibutyl sulfide
2,2'-(硫代二亚甲基)-二呋喃二糠基硫醚	2,2'-(Thiodimethylene)-difuran|2-Furfurylmonosufide|Bis(2-furfuryl)sulfide|Difurfuryl sulphide
二糠基二硫醚	Difurfuryl disulphide
邻-甲硫基苯酚	o-(Methylthio)-phenol
3-甲硫基丙醛	3-(Methylthio) propionaldehyde
8-巯基薄荷酮	p-Mentha-8-thiol-3-one
硫代乙酸糠酯	Furfuryl thioacetate 
3-甲硫基丙酸甲酯	Methyl 3-methylthiopropionate 
3-甲硫基丙酸乙酯	Ethyl 3-methylthiopropionate
吲哚	Indole
三甲基胺	Trimethylamine
玫瑰醚	Rose oxide
羟基香茅醇	Hydroxycitronellol 
3,5-二甲基-1,2,4-三硫杂环戊烷	3,5-Dimethyl-1,2,4-trithiolane 
2-甲基吡嗪	2-Methylpyrazine 
2,3-二甲基吡嗪	2,3-Dimethylpyrazine
2,5-二甲基吡嗪	2,5-Dimethylpyrazine
2,3,5-三甲基吡嗪	2,3,5-Trimethylpyrazine
对-甲苯基乙醛	p-Tolylacetaldehyde
2,6,6-三甲基-1或2-环己烯-1-甲醛	2,6,6-Trimethyl-1 or 2-cyclohexen-1-carboxaldehyde
2-异丁基-3-甲基吡嗪	2-Isobutyl 3-methylpyrazine
2-甲氧基-3-仲丁基吡嗪	2-Methoxy-3-sec-butylpyrazine 
2,3-二乙基吡嗪	2,3-Diethylpyrazine 
3-乙基-2,6-二甲基吡嗪	3-Ethyl-2,6-dimethylpyrazine 
2-乙酰基吡嗪	Acetylpyrazine 
2-乙酰基-3-乙基吡嗪	2-Acetyl-3-ethylpyrazine 
2,3-二乙基-5-甲基吡嗪	2,3-Diethyl-5-methylpyrazine 
5-异丙基-2-甲基吡嗪	5-Isopropyl-2-methylpyrazine 
2,6-二甲基吡啶	2,6-Dimethylpyridine 
4-甲基噻唑	4-Methylthiazole
α-甲基肉桂醛	α-Methylcinnamaldehyde
5-羟乙基-4-甲基噻唑	5-Hydroxyethyl-4-methylthiazole
2,4,5-三甲基噻唑	2,4,5-Trimethylthiazole 
2-乙基-4-甲基噻唑	2-Ethyl-4-methylthiazole 
5-乙烯基-4-甲基噻唑	4-Methyl-5-vinylthiazole 
2-乙酰基噻唑	2-Actylthiazole
2-异丙基-4-甲基噻唑	2-Isopropyl-4-methylthiazole 
2-异丁基噻唑	2-Isobutylthiazole
苯并噻唑	Benzothiazole 
N-糠基吡咯	N-Furfuryl pyrrole 
2-乙酰基吡咯	2-Acetylpyrrole 
5,6,7,8-四氢喹啉	5,6,7,8-Tetrahydroquinoxaline 
2,4,5-三甲基-3- 唑啉	2,4,5-Trimethyl-3-oxazoline 
2-甲基-4-丙基-1,3- 唑烷	2-Methyl-4-propyl-1,3-oxathiane
吡啶	Pyridine
二丙基二硫醚	Propyl disulfide 
2-戊基硫醇	2-Pentanethiol
邻-甲基苯硫酚	o-Toluenethiol
苄基硫醇	Benzyl mercaptan
1-对-?烯-8-硫醇|1-对-薄荷烯-8-硫醇	1-p-Menthene-8-thiol
甲基丙基二硫醚	Methyl propyl disulfide
甲基苄基二硫醚	Methyl benzyl disulfide
甲基糠基二硫醚	Methyl furfuryl disulfide
烯丙基二硫醚	Allyl disulfide
双(2-甲基-3-呋喃基)二硫醚	Bis(2-methyl-3-furyl) disulfide
糠基甲基硫醚	Furfuryl methyl sulfide
2,6-二甲基苯硫酚	2,6-Dimethylthiophenol
2-甲基-3(2-呋喃基)丙烯醛	2-Methyl-3(2-furyl) acrolein 
2-甲基四氢噻吩-3-酮	2-Methyltetrahydrothiophen-3-one 
2-甲基-5-(甲硫基)呋喃	2-Methyl-5-(methylthio) furan 
2-羟基-3,5,5-三甲基-2-环己烯酮	2-Hydroxy-3,5,5-trimethyl-2-cyclohexenone
糠酸甲酯	Methyl 2-furoate
硫代乙酸乙酯	Ethyl thioacetate
硫代乙酸丙酯	Propyl thioacetate 
3-巯基丙酸乙酯	Ethyl 3-mercaptopropionate
硫代丁酸甲酯	Methyl thiobutyrate
异硫氰酸烯丙酯	Allyl isothiocyanate
2-硫代糠酸甲酯	Methyl 2-thiofuroate
3-甲基-1,2,4-三噻烷	3-Methyl-1,2,4-trithiane 
2,3,5,6-四甲基吡嗪	2,3,5,6-Tetramethylpyrazine 
2-乙基吡嗪	2-Ethylpyrazine 
2-乙基-3,(5或6)-二甲基吡嗪	2-Ethyl-3(5 or 6)-dimethylpyrazine 
2-甲氧基-3-异丁基吡嗪	2-Methoxy-3-isobutylpyrazine 
1-甲基-2-乙酰基吡咯	1-Methyl-2-acetylpyrrole 
N-乙基-2-乙酰基吡咯	1-Ethyl-2-acetylpyrrole
喹啉	Quinoline 
6-甲基喹啉	6-Methylquinoline
5-甲基喹噁啉	5-Methylquinoxaline
哌啶	Piperidine
β-甲基吲哚	β-Methylindole 
5-乙基-2-甲基吡啶	5-Ethyl-2-methylpyridine 
3-乙基吡啶	3-Ethylpyridine 
2-乙酰基吡啶	2-Acetylpyridine 
3-乙酰基吡啶	3-Acetylpyridine
甲酸肉桂酯	Cinnamyl formate
异戊胺	Isopentylamine
苯乙胺	Phenethylamine 
2-甲基-1,3-二硫环戊烷	2-Methyl-1,3-dithiolane 
6-乙酰氧基二氢茶螺烷	6-Acetoxydihydrotheaspirane
4,5-二甲基噻唑	4,5-Dimethyl thiazole
3-巯基己醇	3-Mercaptohexanol
三硫丙酮	Trithioacetone
2,6-二甲基吡嗪	2,6-Dimethyl pyrazine 
2-(甲硫基)乙酸乙酯	Ethyl2-(methylthio) acetate
乙酸3-巯基己酯	3-Mercaptohexyl acetate 
2-(甲基二硫基)丙酸乙酯	Ethyl 2-(methyldithio) propionate 
3-(甲硫基)丁酸乙酯	Ethyl 3-(methylthio) butyrate
丁酸3-巯基己酯	3-Mercaptohexyl butyrate
己酸3-巯基己酯	3-Mercaptohexyl hexanoate 
糠醇	Furfuryl alcohol
四氢糠醇	Tetrahydro furfuryl alcohol
牛磺酸|2-氨基乙基磺酸	Taurine|2-Aminoethylsulfonic Acid 
2-乙基-3-甲基吡嗪	2-Ethyl-3-Methylpyrazine 
3-甲基-2-丁硫醇	3-Methyl-2-butanethiol 
2-甲基-3-四氢呋喃硫醇	2-Methyl-3-tetrahydrofuranthiol
丙硫醇	Propanethiol 
1,3-丙二硫醇	1,3-Propanedithiol
烯丙基硫醇|2-丙烯基-1-硫醇	Allyl mercaptan|2-propen-1-thiol
4-甲氧基-2-甲基-2-丁硫醇	4-Methoxy-2-methyl-2-butanethiol
2-苯乙硫醇	2-Phenylethyl mercaptan 
3-巯基-3-甲基-1-丁醇	3-Mercapto-3-methyl-1-butanol
甲基2-甲基-3-呋喃基二硫醚	Methyl2-methyl-3-furyl disufide
甲基乙基硫醚	Methyl ethyl sulfide 
甲基苯基二硫醚	Methyl phenyl disulfide
二乙基硫醚	Diethyl sulfide
二丙基三硫醚	Dipropyl trisulfide 
丙烯基丙基二硫醚	Propenyl propyl disulfide
二烯丙基硫醚	Allyl sulfide
二烯丙基三硫醚	Diallyl trisulfide
二烯丙基四硫醚|二烯丙基聚硫醚	Diallyl tetrasulfide|Diallyl polysulfide
2-甲硫甲基-2-丁烯醛	2-(Methylthio)methyl-2-butenal 
3-甲硫基己醛	3-Methyl thiohexanal
乙酸环己酯	Cyclohexyl acetate
邻-氨基苯乙酮	o-Amino acetophenone
2-甲基-3-甲硫基呋喃	2-Methyl-3-(methylthio) furan
甲酸3-巯基3-甲基丁酯	3-Mercapto-3-methyl-butyl formate
乙酸3-甲硫基丙酯	3-(Methylthio)propyl acetate 
3-甲基硫代丁酸S-甲酯|异戊酸甲硫醇酯	S-Methyl 3-methylbutanethioate |Methylthiolisovalerate
甲硫磺酸S-甲酯	S-Methyl methanethiosulfonate
2-甲硫基丁酸甲酯	Methyl 2-methythio butyrate 
3-甲硫基-1-己醇乙酸酯	3-(Methylthio)-1-hexyl acetate
甲硫醇乙酸酯	S-methyl thioacetate 
(5H)-5-甲基-6,7-二氢环戊基并(b)吡嗪	(5H)-5-Methyl-6,7-dihydro-cyclopenta(b) pyrazine 
2-甲氧基吡嗪	2-Methoxypyrazine 
2-,5或6-甲氧基-3-甲基吡嗪	2-,5 or 6-Methoxy-3-methylpyrazine 
2-乙酰基-3,5(或6)-二甲基吡嗪	2-Acetyl-3,5(or 6)dimethyl pyrazine 
2-乙酰基3-甲基吡嗪	2-Acetyl 3-methyl pyrazine
四氢吡咯|吡咯烷	Tetrahydropyrrole|Pyrrolidine 
2-异丁基吡啶	2-Isobutyl pyridine 
2-乙基-4,5-二甲基噁唑	2-Ethyl-4,5-dimethyloxazole
硫化铵	Ammonium sulfide 
2-巯基丙酸乙酯	Ethyl 2-mercaptopropionate 
N-(4-羟基-3-甲氧基苄基)壬酰胺	N-(4-Hydroxy-3-methoxybenzyl)-nonanamide 
1,4-二噻烷	1,4-Dithiane
桃金娘烯醇	Myrtenol
胡椒碱	Piperine 
2,3-二甲基苯并呋喃	2,3-Dimethylbenzofuran 
4-羟基-5-甲基-3(2H)-呋喃酮	4-Hydroxy-5-methyl-3-(2H)-furanone
γ-紫罗兰酮	γ-Ionone
α-二氢紫罗兰酮	Dihydro-Alpha-ionone 
d-胡椒酮|对-?-1-烯-3-酮	d-Piperitone|p-menth-1-en-3-one)
胡椒烯酮|对-?-1,4(8)-二烯-3-酮	Piperitenone|p-Mentha-1,4(8)-dien-3-one) 
L-天冬氨酸	L-Aspartic acid 
DL-异亮氨酸	DL-Isoleucine
焦木酸提取物	Pyroligneous acid extract
乙酸钠|醋酸钠	Sodium acetat
双乙酸钠|二醋酸钠	Sodium diacetate
琥珀酸二钠	Disodium succinate 
5'-鸟苷酸二钠	Disodium 5'-guanylate 
5'-肌苷酸二钠	Disodium 5'-inosinate
磷酸三钙	Tricalcium phosphate
δ-十六内酯	δ-Hexadecalactone 
(+/-)二氢薄荷内酯	(+/-)Dihydromintlactone
顺式-4-十二烯醛	(Z)-4-Dodecenal
4,5-环氧反式-2-癸烯醛	4,5-Epoxytrans-2-decenal
2-乙基-5-甲基吡嗪	2-Ethyl-5-methylpyrazine
顺式-3-顺式-6-壬二烯-1-醇	cis-3-cis-6-Nonadien-1-ol 
2-甲基-1-丁醇	2-Methyl-1-butanol
异龙脑	Isoborneol 
2-壬醇	2-Nonano
反式-2-辛烯-1-醇	(E)-2-Octen-1-ol|trans-2-Octen-1-ol
香芹醇	Carveol
对-?烷-2-酮|对-薄荷烷-2-酮	p-Menthan-2-one 
4-甲基-3-戊烯-2-酮	4-Methyl-3-penten-2-one
反式,反式-3,5-辛二烯-2-酮	trans,trans-3,5-Octadien-2-one 
2-甲基呋喃	2-Methylfuran 
3-癸烯-2-酮	3-Decen-2-one 
2-辛烯-4-酮	2-Octen-4-one 
2-呋喃基-2-丙酮	(2-Furyl)-2-propanone 
5-甲基-2,3-己二酮	5-Methyl-2,3-hexanedione 
2-甲基-3-戊烯酸	2-Methyl-3-pentenoic acid
L-酪氨酸	L-Tyrosine
2-氧代戊二酸	2-Oxopentanedioic acid 
4-茴香酸	4-Anisic acid
亚油酸	Linoleic acid
甘草酸	Glycyrrhizic acid 
L-胱氨酸	L-Cystine 
L-蛋氨酸	L-Methionine
L-谷氨酰胺	L-Glutamine
2-丙硫醇	2-Propanethiol 
4-巯基-4-甲基-2-戊酮	4-Mercapto-4-methyl-2-pentanone
1,2-乙二硫醇	1,2-Ethanedithiol
异戊烯基硫醇	Prenyl mercaptan
d,l-(3-氨基-3-羧基丙基)二甲基氯化锍|甲基蛋氨酸-氯化锍	d,l-(3-Amino-3-carboxypropyl) dimethyl sulfonium chloride|d,l-Methylmethionine sulfonium chloride
2-甲基-3-硫代乙酰氧基-4,5-二氢呋喃	2-Methyl-3-thioacetoxy-4,5-dihydrofuran
异丁基硫醇	Isobutyl mercaptan
苯硫酚|苄基硫醇	Benzenethiol
异硫氰酸苄酯	Benzyl isothiocyanat
甲基烯丙基三硫醚	Allyl methyl trisulfide
2-戊基噻吩	2-Pentyl thiophene 
3,5-二乙基-1,2,4-三硫杂环戊烷	3,5-Diethyl-1,2,4-trithiolane
噻吩	Thiophene 
2,4,6-三甲基二氢-4H-1,3,5-二噻嗪	2,4,6-Trimethyldihydro-4H-1,3,5-dithiazine
异硫氰酸3-甲硫基丙酯	3-Methylthiopropyl isothiocyanate 
3-甲基丁基硫醇	3-Methylbutanethiol
2-乙酰基-2-噻唑啉	2-Acetyl-2-thiazoline
甲基丙基三硫醚	Methyl propyl trisulfide
噻唑	Thiazole
吡嗪	Pyrazine
甲基1-丙烯基二硫醚	Methyl 1-propenyl disulfide
甲酸丙酯	Propyl formate 
香兰素3-(l-?氧基)丙-1,2-二醇缩醛|香兰素3-(l-薄荷烷氧基)丙-1,2-二醇缩醛	Vanlillin 3-(l-menthoxy) propane-1,2-diol acetal 
3-戊烯-2-酮	3-Penten-2-one
十二酸甲酯|月桂酸甲酯	Methyl dodecanoate|Methyl laurate
乙酸紫苏酯|对-1,8-?二烯-7-醇乙酸酯	Perillyl acetate|p-Mentha-1,8-dien-7-yl acetate
苹果酸二乙酯	Diethyl malate
甲硫基乙酸甲酯	Methyl(methylthio) acetate
2-乙酰基-1-吡咯啉	2-Acetyl-1-pyrroline
甲酸异丙酯	Isopropyl formate 
4-甲基-2-戊烯醛	4-Methyl-2-pentenal
亚油酸乙酯	Ethyl linoleate
2,4,6-三异丁基-5,6-二氢-4H-1,3,5-二噻嗪	2,4,6-Triisobutyl-5,6-dihydro-4H-1,3,5-dithiazine
乙酸十二醇酯	Dodecyl acetate 
2-乙基丁醛	2-Ethyl butyraldehyde
辛酸辛酯	Octyl caprylate
己醛二乙缩醛	Hexanal diethyl acetal
丙酸异丙酯	Isopropyl propionate
丁酸反式-2-己烯酯	trans-2-Hexenyl butyrate
异硫氰酸丁酯	Butyl Isothiocyanate 
N-葡糖酰基乙醇胺	N-Gluconyl ethanolamine 
N-乳酰基乙醇胺	N-Lactoyl ethanolamine
1-庚烯-3-醇	1-Hepten-3-ol
乙硫醇	Ethanethiol
六偏磷酸钠	Sodium hexameta phosphate
乙酸l-龙脑酯	l-Bornyl acetate
反式-α-突厥酮	trans-α-Damascone
二乙基二硫醚	Diethyl disulfide 
2,5-二甲基-3(2H)-呋喃酮	2,5-Dimethyl-3(2H)-furanone
香叶酸	Geranic acid 
1-(3-羟基-5-甲基-2-噻吩)乙酮	1-(3-Hydroxy-5-methyl-2-thienyl) ethanone
异黄葵内酯	Isoambrettolide
异丁酸异龙脑酯	Isobornyl isobutyrate 
N-甲基邻氨基苯甲酸异丁酯	Isobutyl N-methylanthranilate
丁酸3-(甲硫基)丙酯	Methionyl butyrate [3-(Methylthio) propylbutyrate]
(S1)-甲氧基-3-庚硫醇	(S1)-Methoxy-3-heptanethiol 
5-Z-辛烯酸甲酯	Methyl 5-Z-octenoate 
N-乙酰基邻氨基苯甲酸甲酯	Methyl N-acetylanthranilate
3-甲基-2-(3-甲基-2-丁烯)呋喃	3-Methyl-2-(3-methylbut-2-enyl) furan
乙酸植醇酯	Phytyl acetate 
3,7,11-三甲基十二碳-2,6,10-三烯醇乙酸酯	3,7,11-Trimethyldodeca-2,6,10-trienyl acetate
三乙胺	Triethylamin
丙酸茴香酯	Anisyl propionate
丁酸3-丁酮-2-醇酯	Butan-3-one-2-yl butanoate
异喹啉	Isoquinoline
2-丙酰噻唑	2-Propionylthiazole 
2(4)-异丙基-4(2),6-二甲基二氢(4H)-1,3,5-二噻嗪	2(4)-Isopropyl-4(2),6-dimethyldihydro(4H)-1,3,5-dithiazine
丁酸松油酯	Terpinyl butyrat
3-正丁基苯酞	3-n-Butylphthalide 
2,2-二甲基-5-(1-甲基-1-丙烯基)四氢呋喃	2,2-Dimethyl-5-(1-methylpropen-1-yl) tetrahydrofuran
(6R)-3-甲基-6-(1-甲基乙基)-2-环己烯-1-酮	2-Cyclohexen-1-one,3-methyl-6-(1-methylethyl)-,(6R)-
3-甲基-2-丁烯-1-醇	3-Methyl-2-buten-1-ol
对-?-1-烯-9-醇乙酸酯|对-1-薄荷烯-9-醇乙酸酯	1-p-Menthen-9-yl acetate
乙酸2-辛烯醇酯	2-Octen-1-yl acetate 
1-(对-甲氧基苯基)-2-丙酮	1-(p-Methoxyphenyl)-2-propanone
十八酸丁酯|硬脂酸丁酯	Butyl octadecanoate|Butyl stearate
(+/-)-1-苯乙基硫醇	(+/-)-1-Phenylethylmercaptan
4-异丙基-2-环己烯酮	4-Isopropyl-2-cyclohexenone
邻-甲氧基苯甲酸甲酯	Methyl o-methoxybenzoate
丙酮醛	Pyruvaldehyde
甲基乙基三硫醚	Methyl ethyl trisulfide
2-甲基-2-(甲二硫基)-丙醛	2-Methyl-2-(methyldithio) propanal
二(甲硫基)甲烷	Bis-(Methylthio) methane 
2,3,5-三硫杂己烷	2,3,5-Trithiahexane 
4-乙基辛酸	4-Ethyl octanoic acid
二氢诺卡酮	Dihydronootkatone 
1-乙氧基-3-甲基-2-丁烯	1-Ethoxy-3-methyl-2-butene 
2-乙烯基-2-甲基-5-(1-甲基乙烯基)四氢呋喃	2-Ethenyl-2-methyl-5-(1-methylethenyl)-tetrahydrofuran
异戊酸糠酯	Furfuryl isovalerate
异戊酸芳樟酯	Linalyl isovalerat
3-甲基-2-丁醇	3-Methyl-2-butanol 
3-甲基-1-戊醇	3-Methyl-1-pentanol 
4-甲基-2-戊酮	4-Methyl-2-pentanone
反式-3-顺式-6-壬二烯醇	trans-3-cis-6-Nonadienol 
庚酸甲酯	Methyl heptanoate
顺式-3-己烯醇丙酸酯	(Z)-3-Hexenyl propionat
反式-2-癸烯酸乙酯	Ethyl trans-2-decenoate 
2-乙基苯酚	2-Ethyl phenol
盐酸硫胺素	Thiamine hydrochloride 
N-甲基吡咯-2-甲醛	N-Methyl pyrrol-2-carboxaldehyd
乙酸香兰素酯	Vanillin acetate
L-组氨酸	L-Histidine
δ-突厥酮	δ-Damascone 
2-甲基戊酸乙酯	Ethyl 2-methylpentanoate 
4-甲硫基-2-丁酮	4-Methylthio-2-butanone
乳酸l-薄荷酯	l-Menthyl lactate
甲基3-甲基-1-丁烯基二硫醚	Methyl 3-methyl-1-butenyl disulfide 
1-巯基-2-丙酮	1-Mercapto-2-propanon
乙酸正戊酯	Pentyl acetat
胡薄荷酮	Pulegone 
1-苯基丙醇-1	1-Phenylpropan-1-ol 
4-苯基2-丁醇	4-Phenyl-2-butanol
庚醇-3	Heptan-3-ol 
3-乙酰氧基己酸甲酯	Methyl 3-acetoxy hexanoate
对-?-1-烯-3-醇|对-1-薄荷烯-3-醇	p-Menth-1-en-3-ol 
4-醇|4-侧柏醇	4-Thujanol
丙酮酸顺式-3-己烯酯|丙酮酸叶醇酯	cis-3-Hexenyl pyrovate|Leaf pyrovate
联苯	Biphenyl	
顺式-4-羟基-6-十二烯酸内酯	(Z)-4-Hydroxy-6-dodecenoic acid lactone
甲基亚磺酰甲烷	Methylsulfinylmethane 
3,7-二甲基-2,6-辛二烯酸甲酯|香叶酸甲酯	Methyl 3,7-dimethyl-2,6-octadienoate|methygeranate
反式和顺式-4,8-二甲基-3,7-壬二烯-2-酮	(E) and (Z)-4,8-Dimethyl-3,7-nonadien-2-one
异亚戊基异戊胺	Isopentylidene isopentylamine
戊酸异戊酯	Isoamyl valerate
丙酸反式-2-己烯酯	trans-2-Hexenyl propionate 2-Hexen-1-ol,propanoate,(E)
硫化氢(仅用于热反应香料) Hydrogen sulfide
戊酸甲酯	Methyl valerate
丁酸异丙酯	Isopropyl butyrate
烯丙基甲基二硫醚	Allyl methyl disulfide 
3-壬酮	3-Nonanone
二苄基二硫醚	Benzyl disulfide
苯乙酸顺式-3-己烯酯|苯乙酸叶醇酯	cis-3-Hexenyl phenylacetate|Leaf phenylacetate
乙酸3-(乙酰巯基)己酯	3-Acetylmercaptohexyl acetate
己酸甲硫醇酯	S-Methyl hexanethioate|methyl thiohexanoate
反式-2-丁烯酸|巴豆酸	(E)-2-Butenoic acid|Crotonic acid
戊酸顺式-3-己烯酯|戊酸叶醇酯	(Z)-3-Hexenyl valerate|Leaf valerate
己酸苄酯	Benzyl hexanoate
烯丙基丙基二硫醚	Allyl propyl disulfide 
2,8-表硫-顺式-对-?烷	2,8-Epithio-cis-p-menthane
4,7,7-三甲基-6-硫杂双环[3.2.1]辛烷硫代桉叶素	4,7,7-Trimethyl-6-thiabicyclo[3.2.1]octane Thiocineole
癸酸甲酯	Methyl decanoate
甲酸异丁酯	Isobutyl formate
4-庚酮	4-Heptanone
戊酸丁酯	Butyl valerate
丁酸环己酯	Cyclohexyl butyrate
山梨酸乙酯|2,4-己二烯酸乙酯	Ethyl sorbate|Ethyl 2,4-hexadiencate
单油酸甘油酯	Glyceryl monooleate 
5-羟基-4-辛酮	5-Hydroxy-4-octanone
壬酸甲酯	Methyl nonanoate
丙酸橙花酯	Neryl propionate
肉桂酸丙酯	Propyl cinnamate
丁酸玫瑰酯	Rhodinyl butyrate
异丁酸玫瑰酯	Rhodinyl isobutyrate
丙酸松油酯	Terpinyl propionate
丙酸糠酯	Furfuryl propionate
戊酸糠酯	Furfuryl pentanoate
异茉莉酮	Isojasmone
苄基甲基硫醚	Benzyl methyl sulfide
3-甲基-2-丁烯醛	3-Methyl-2-butenal 
2,4-癸二烯酸丙酯	Propyl 2,4-decadienoate
反式-2-己烯酸己酯	Hexyl trans-2-hexenoate 
4-烯丙基-2,6-二甲氧基苯酚	4-Allyl-2,6-dimethoxyphenol
2-羟基-4-甲基戊酸甲酯	Methyl 2-hydroxy-4-methylpentanoate
反式-2-辛烯酸甲酯	Methyl trans-2-octenoate 
2,2,6-三甲基-6-乙烯基四氢吡喃	2,2,6-Trimethyl-6-vinyltetrahydropyran
香紫苏内酯	Sclareolide|Decahydro-3a,6,6,9a-tetramethylnaphtho(2,1b)furan-2(1H )-one
苯甲酸甲硫醇酯	S-Methyl benzothioate
反式-2-己烯酸顺式-3-己烯酯	(Z)-3-Hexenyl(E)-2-hexenoate
2-巯基苯甲醚	2-Mercaptoanisole
香兰素苏和赤-2,3-丁二醇缩醛	Vanillin erythro and threo-butan-2,3-diol acetal
反式6-甲基-3-庚烯-2-酮	(E)-6-Methyl-3-hepten-2-one 
(±)3-巯基丁酸乙酯	(±)-Ethyl 3-mercaptobutyrate 
3-巯基-2-甲基戊醇	3-Mercapto-2-methylpentan-1-ol
乙醛二异戊醇缩醛	Acetalde hydediisoamyl acetal 
(+/-)-2-苯基-4-甲基-2-己烯醛	(+/-)-2-Phenyl-4-methyl-2-hexenal 
2-庚硫醇	2-Heptanethiol 
2-(2-羟基-4-甲基-3-环己烯基)-丙酸γ-内酯	2-(2-Hydroxy-4-methyl-3-cyclohexenyl)-propionic acid γ-lactone(Wine Lactone) 
l-?基甲基醚|2-异丙基-5-甲基环己基甲基醚	l-Menthyl methyl ether (2-Isopropyl-5-methylcyclohexyl methyl ehter)
己酸异丙酯	Isopropyl hexanoate 
2,4-己二烯-1-醇	2,4-Hexadien-1-ol
十六烷酸甲酯	Methyl hexadecanoate 
5-甲基-2-噻吩甲醛	5-Methyl-2-thiophenecarboxaldehyde 
4-甲基-2,6-二甲氧基苯酚	4-Methyl-2,6-dimethoxyphenol
对-甲氧基肉桂醛	p-Methoxycinnamaldehyde 
2,4,5-三甲基唑	2,4,5-Trimethyloxazole
苯甲醛二乙缩醛	Benzaldehyde diethyl acetal 
d-新薄荷醇	d-Neo-Menthol 
2-壬烯酸γ-内酯	2-Nonenoic acid gamma-lactone
反式-4-癸烯酸乙酯	Ethyl trans-4-decenoate
晚香玉内酯|二氢-5-[(Z,Z)-2,5-辛二烯-2(3H )-呋喃酮	Tuberose Lactone|Dihydro-5-[(Z,Z )-octa-2,5-dienyl]-2(3H)-furanone
4-甲基-2-戊基-1,3-二氧戊环|己醛1,2-丙二醇缩醛	4-Methyl-2-pentyl-1,3-dioxolane (Hexanal propylene glycol acetal)
乙酸3-巯基庚酯	3-Mercaptoheptyl acetate
甲基纤维素	Methyl cellulose
植醇|叶绿醇|叶黄烯醇|3,7,11,15-四甲基-2-十六烯-1-醇	phytol|3,7,11,15-Tetramethyl-2-hexadecen-1-ol
异戊醛二乙缩醛	Isovaleraldehyde diethy lacetal
异硫氰酸3-丁烯酯	3-Butenyl isothiocyanate
异硫氰酸4-戊烯酯	4-Pentenyl isothiocyanate
异硫氰酸5-己烯酯	5-Hexenyl isothiocyanate
顺式-9-十八烯醇乙酸酯|乙酸油醇酯	cis-9-Octadecenyl acetate|Oleyl acetate
糠基甲基醚	Furfuryl methy lether
3-己酮	3-Hexanone
异硫氰酸2-丁酯	2-Butyl isothiocyanate
异硫氰酸异丁酯	Isobutyl isothiocyanate
异硫氰酸6-(甲硫基)己酯	6-(Methylthio) hexyl isothiocyanate
异硫氰酸5-(甲硫基)戊酯	5-(Methylthio) pentyl isothiocyanate
异硫氰酸戊酯	Amyl isothiocyanate
异硫氰酸异丙酯	Isopropyl isothiocyanate
异硫氰酸异戊	Isoamyl isothiocyanate 
2,5-二甲基呋喃	2,5-Dimethylfuran
环紫罗兰酮	Cycloionone 
2-异丁基-4-甲基-1,3-二氧戊环|异戊醛1,2-丙二醇缩醛	2-Isobutyl-4-methyl-1,3-dioxolane|Isovaleraldehyde propylene eglycol acetal
顺式和反式-2-异丙基-4-甲基-1,3-二氧戊环|异丁醛1,2-丙二醇缩醛	cis-and trans-2-Isopropyl-4-methyl-1,3-dioxolane|Isobutyraldehyde propylene glycol acetal
4-氨基丁酸|γ-氨基丁酸	4-Aminobutyric acid|Gamma-Aminobutyric acid
N-[2-(3,4-二甲氧基苯基)乙基]-3,4-二甲氧基肉桂酸酰胺	N-[2-(3,4-Dimethoxyphenyl) ethyl]-3,4-dimethoxycinnamic acid amide
二-(1-丙烯基)硫醚(异构体混合物)	Di-(1-propenyl)-sulfide(mixture of isomers)
乙酸2-戊酯	2-Pentyl acetate
乙胺	Ethylamine
2,8-二硫杂-4-壬烯-4-甲醛[5-(甲硫基)-2-(甲硫基甲基)-2-戊烯醛]	2,8-Dithianon-4-en-4-carboxaldehyde5-(Methylthio)-2-(methylthiomethyl)-2-pentenal Methialdol
1-丁烯-1-基甲基硫醚	1-Buten-1-ylmethylsulfide
二异丙基二硫醚	Diisopropyl disulfide
(E)-2-癸烯酸	(E)-2-Decenoic acid
l-苧烯	l-Limonene 
正己硫醇	1-Hexanethiol
2-癸酮	2-Decanone
二糠基醚	Difurfuryl ether 
异丁酸乙基香兰素酯	Ethyl vanillin isobutyrate
8-罗勒烯醇乙酸酯|2,6-二甲基-2,5,7-辛三烯-1-醇乙酸酯	8-Ocimenyl acetate|2,6-Dimethyl-2,5,7-octatriene-1-yl acetate
丁胺	Butylamine
1-氨基-2-丙醇	1-Amino-2-propanol
反式-1,5-辛二烯-3-酮	(E)-1,5-Octadien-3-one
2,5-二甲基-4-乙氧基-3(2H)-呋喃酮	2,5-dimethyl-4-ethoxy-3(2H)-furanone
反式-2-顺式-4-顺式-7-十三碳三烯醛	2-trans-4-cis-7-cis-Tridecatrienal
反式-2-顺式-4-癸二烯酸甲酯	Methyl(E)-2-(Z)-4-decadienoate
2-(4-甲基-2-羟基苯基)-丙酸-γ-内酯	2-(4-Methyl-2-hydroxyphenyl) propionic acid-γ-lactone
丙酸顺式-5-辛烯酯	(Z)-5-Octenyl propionate
3-甲基-2-丁烯硫醇乙酸酯	3-Methyl-2-butenyl thioacetate (Prenyl thioacetate)
1-吡咯啉	1-Pyrroline
2-2,3,4-三甲基-3-戊醇	2,3,4-Trimethyl-3-pentanol
二异丙基三硫醚	Diisopropyl trisulfide
2-丙酰基-1-吡咯啉	2-Propionyl-1-pyrroline
3,6-二乙基-1,2,4,5-四硫杂环己烷与3,5-二乙基-1,2,4-三硫杂环戊烷的混合物	Mixture of 3,6-Diethyl-1,2,4,5-tetra thiane and 3,5-diethyl-1,2,4-trithiolane
2,5-二羟基-1,4-二噻烷|巯基乙醛二聚体	2,5-Dihydroxy-1,4-dithiane|Mercaptoacet aldehyde dimer
3-己烯醛(反式/顺式混合物)	3-Hexenal(trans/cis mix)
4-羟基-3,5-二甲氧基苯甲醛	4-Hydroxy-3,5-dimethoxybenzaldehyde
2-十一烯-1-醇	2-Undecen-1-ol
2-(4-羟基苯基)-乙胺|酪胺	2-(4-hydroxyphenyl)ethylamine|Tyramine
4[(2-呋喃甲基)硫基]-2-戊酮|4-糠硫基-2-戊酮	4-[(2-Furanmethyl)thio]-2-pentanone|4-Furfurylthio-2-pentanone
己酸甲硫基甲酯	Methylthiomethyl hexanoate
2,6-二甲基-4-庚酮	2,6-Dimethyl-4-heptanone|Diisobutyl ketone
d-香芹酮	d-carvone
反式-3-己烯醇	trans-3-hexenol
甲酸松油酯	terpinyl formate
脱氢圆柚酮	dehydronootkatone
己酸香叶酯	geranyl hexanoate
3-甲基己醛	3-methyl hexanal
(反式,反式)-2,4-壬二烯	(E,E)-2,4-nonadiene
1-辛烯	1-octene
2-甲基苯乙酮	2-methyl acetophenone
1-乙基-2-甲酰基吡咯|茶吡咯	1-ethyl-2-formylpyrrole|Tea pyrrole
2-(4-甲基-5-噻唑基)乙醇辛酸酯	2-(4-methyl-5-thiazolyl) ethyl octanoate
2-乙基-6-甲基吡嗪	2-ethyl-6-methylpyrazine
对-丙基苯酚	p-propylphenol
3,5-二乙基-2-甲基吡嗪	3,5-diethyl-2-methylpyrazine
马鞭草烯酮	verbenone
4-戊烯醛	4-pentenal
乙酰乙酸乙酯丙二醇缩酮	ethyl acetoacetate propylene glycol ketal
山梨酸甲酯	methyl sorbate
2,5-二乙基四氢呋喃	2,5-diethyl tetrahydrofurane
脱氢薄荷呋喃内酯	dehydromenthofurolactone
乙酸桃金娘烯酯	myrtenyl acetate
2-(4-甲基-5-噻唑基)乙醇己酸酯 2-(4-methyl-5-thiazolyl) ethyl hexanoate
2-(4-甲基-5-噻唑基)乙醇丁酸酯 2-(4-methyl-5-thiazolyl) ethyl butyrate
吡咯	pyrrole
S-烯丙基-L-半胱氨酸	S-allyl-L-cysteine
2-巯基-3-丁醇	2-Mercapto-3-butanol
硫代香叶醇	Thiogeraniol
蒎烷硫醇	Pinanylmercaptan
α-甲基-β-羟基丙基α-甲基-β-巯丙基硫醚	α-Methyl-β-hydroxypropylα-methyl-β-mercaptopropyl sulfide
乙基麦芽酚	Ethylmaltol
柠檬醛二乙缩醛	Citral diethyl acetal
4-丙烯基-6-乙氧基苯酚|丙烯基乙基愈创木酚	3-Propenyl-6-ethoxyphenol|Propenylguaethol
β-甲基紫罗兰酮	Methyl-β-ionone
δ-甲基紫罗兰酮	Methyl-δ-ionone
2,6-壬二烯醛二乙缩醛	2,6-Nonadienal diethyl acetal
9-十一烯醛	9-Undecenal
10-十一烯醛	10-Undecenal
十六醛|杨梅醛	AldehydeC-16pure|Strawberry aldehyde
乙基香兰素	Ethyl vanillin
兔耳草醛|仙客来醛	Cyclamen aldehyde
羟基香茅醛	Hydroxycitronellal
β-环高柠檬醛	β-Homocyclocitral
l-薄荷酮甘油缩酮	l-Menthone1,2-glycerol Ketal
4-甲硫基-4-甲基-2-戊酮	4-(Methylthio)-4-methyl-2-pentanone
3-巯基-2-戊酮	3-Mercapto-2-pentanone
d,l-薄荷酮甘油缩酮	d,l-Menthone1,2-glycerol Ketal
α-甲基紫罗兰酮	Methyl-α-ionone
α-异甲基紫罗兰酮	α-iso-Methylionone
烯丙基α-紫罗兰酮	Allyl α-ionone
6-甲基香豆素	6-Methylcoumarin
2-巯基丙酸	2-Mercaptopropionic acid
2-甲基-4-戊烯酸	2-Methyl-4-pentenoic acid
乙酸二甲基苄基原酯	Benzyl dimethyl carbinyl acetate
环己基乙酸烯丙酯	Allyl cyclohexaneacetate
乙酸玫瑰酯	Rhodinyl acetate
3-(2-呋喃基)丙酸乙酯	Ethyl 3(2-furyl)propanoate
丙酸烯丙酯	Allyl propionate
3-环己基丙酸烯丙酯	Allyl 3-cyclohexylpropionate
3-(2-呋喃基)丙酸异丁酯	Isobutyl 3-(2-furan)propionate
硫代丙酸糠酯	Furfuryl thiopropionate
丁酸二甲基苄基原酯	Dimethyl benzyl carbinyl butyrate
环己基丁酸烯丙酯	Allyl cyclohexanebutyrate
1,3-壬二醇乙酸酯(混合酯)	1,3-Nonanediol acetate(mixedesters)
丁酸苏合香酯	Styralyl butyrate
乙酸柏木酯	Cedryl acetate
异丁酸麦芽酚酯	Maltol isobutyrate
2-甲基-4-戊烯酸乙酯	Ethyl 2-methyl-4-pentenoate
乙酸四氢糠酯	Tetrahydrofurfuryl acetate
庚炔羧酸甲酯	Methyl heptine carbonate
辛炔羧酸甲酯	Methyl octyne carbonate
癸二酸二乙酯	Diethyl sebacate
10-十一烯酸乙酯	Ethyl 10-undecenoate
苯乙酸烯丙酯	Allyl phenylacetate
三乙酸甘油酯	Triacetin
苯乙酸香叶酯	Geranyl phenylacetate
苯乙酸对-甲酚酯	p-Cresyl phenylacetate
4-苯基丁酸甲酯|苯丁酸甲酯	Methyl 4-phenylbutyrate
4-苯基丁酸乙酯|苯丁酸乙酯	Ethyl 4-phenylbutyrate
肉桂酸烯丙酯	Allyl cinnamate
2-甲基-3-戊烯酸乙酯	Ethyl 2-methyl-3-pentenoate
亚硝酸乙酯	Ethyl nitrite
庚酸戊酯	Amyl heptanoate
3-乙酰基-2,5-二甲基呋喃	3-Acetyl-2,5-dimethylfuran
2,5-二甲基-3-氧代(2H)-4-呋喃丁酸酯	2,5-Dimethyl-3-Oxo-(2H)-fur-4-yl butyrate
2-甲氧基-3(5或6)-异丙基吡嗪	2-Methoxy-3(5or6)-isopropylpyrazine
2-甲基-3(5或6)-糠硫基吡嗪	2-Methyl-3,5-or6-(furfurylthio)-pyrazine(mixture of isomers)
2-甲基(或乙基)-3(5或6)-甲氧基吡嗪	2-Methyl(or ethyl)-3(5or6)-methoxypyrazine
2,5-二甲基-2,5-二羟基-1,4-二硫代环己烷	2,5-Dimethyl-2,5-dihydroxy-1,4-dithiane
5,7-二氢-2-甲基噻吩并(3,4-d)嘧啶	5,7-Dihydro-2-methylthieno(3,4-d)-pyrimidin
2-乙氧基噻唑	2-Ethoxythiazole
2,4-二甲基-5-乙酰基噻唑	2,4-Dimethyl-5-acetylthiazole
乙酸异丁香酯	Isoeugenyl acetate
3-甲基丁酸对-甲酚酯|异戊酸对甲酚酯	p-Methylphenyl 3-methylbutyrate|p-Cresyl isovalerate
l-薄荷醇乙二醇碳酸酯	l-Menthol ethylene glycol carbonate
3-(2-甲基丙基)吡啶	3-(2-Methylpropyl) pyridine
乙基香兰素1,2-丙二醇缩醛	Ethylvanillin propylene glycol acetal
人造康乃克油	Artificial cognac oil
山楂核烟熏香味料Ⅰ号	Smoking flavorings No.Ⅰ made from hawthornkernels
山楂核烟熏香味料Ⅱ号	Smoking flavorings No.Ⅱ made from hawthornkernels
苄基异丁基原醇|α-异丁基苯乙醇	Isobutyl benzyl carbinol|α-Butyl isophenethyl alcohol
4-苯基-3-丁烯-2-醇	4-Phenyl-3-buten-2-ol
2-甲基-4-苯基-2-丁醇	2-Methyl-4-phenyl-2-butanol
l-薄荷醇丙二醇碳酸酯	l-Menthol 1-(or2-)-propylene glycol carbonate
辛酸烯丙酯	Allyl octanoate
α-丙基苯乙醇	α-Propylphenethyl alcohol
龙葵醇|β-甲基苯乙醇	Hydratropyl alcohol|β-Methylphenethyl alcohol
四氢芳樟醇	Tetrahydrolinalool
2,3-二巯基丁烷	2,3-Dimercaptobutane
β-萘乙醚	β-Naphthyl ethyl ether
异丁基β-萘醚	β-Naphthyl isobutyl ether
邻-丙基苯酚	o-Propylphenol
苄基异丁香酚	Isoeugenyl benzyl ether
2-甲基-3(5或6)-甲硫基吡嗪	2-Methyl-3(5or6)-(methylthio) pyrazine
香茅氧基乙醛	Citronellyloxyacetaldehyde
乙醛苯乙醇丙醇缩醛	Acetaldehyde phenylethyl propyl acetal
2-甲基-3-(对甲基苯基)丙醛	2-Methyl-3-(p-methylphenyl) propanal Satinaldehyde
香茅氧基乙醛	Citronellyloxyacetaldehyde
乙醛苯乙醇丙醇缩醛	Acetalde hydephenyl ethylpropyl acetal
2-甲基-3-(对甲基苯基)丙醛	2-Methyl-3-(p-methylphenyl)propanal Satinaldehyde
2-苯基-3-(2-呋喃基)丙-2-烯醛	2-Phenyl-3-(2-furyl)prop-2-enal
3,5,5-三甲基己醛	3,5,5-Trimethylhexanal
2-甲基-3(5或6)-乙氧基吡嗪	2-Methyl-3(5or6)-ethoxypyrazine
庚醛甘油缩醛	Heptanal glyceryl acetal
苯乙醛甘油缩醛	Phenylacetaldehyde glyceryl acetal
对-异丙基苯乙醛	p-Isopropyl phenylacetaldehyde
2-甲基-4-苯丁醛	2-Methyl-4-phenylbutyraldehyde
龙葵醛	Hydratropic aldehyde
龙葵醛二甲缩醛	Hydratropic aldehyde dimethyl acetal
羟基香茅醛二乙缩醛	Hydroxycitronel laldiethyl acetal
柠檬醛二甲缩醛	Citral dimethyl acetal
4-甲基-5-(2-乙酰氧乙基)-噻唑	4-Methyl-5-(2-acetoxyethyl) thiazole
α-丁基肉桂醛	α-Butylcinnamaldehyde
4-庚烯-3-酮	4-Heptene-3-one
4-甲基-1-苯基-2-戊酮	4-Methyl-1-phenyl-2-pentanone
1-(对-甲氧基苯基)-1-戊烯-3-酮	1-(p-Methoxyphenyl)-1-penten-3-one
α-己叉基环戊酮	α-Hexylidenecyclopentanone
四甲基乙基环己烯酮	Tetramethyl ethylcyclohexenone
糠硫醇甲酸酯	Furfurylthiol formate
甲基β-萘酮	Methyl β-naphthyl ketone
2-(3-苯丙基)四氢呋喃	2-(3-Phenylpropyl)tetrahydrofuran
烯丙基乙酸	Allyl acetic acid
甲酸二甲基苄基原酯	Dimethyl benzyl carbinyl formate
4-乙酰基-6-叔丁基-1,1-二甲基茚满	4-Acetyl-6-t-butyl-1,1-dimethylindane
癸醛二甲缩醛|1,1-二甲氧基癸烷	Decanal dimethyl acetal|1,1-Dimethoxydecane
乙酸环己基乙酯	Cyclohexaneethyl acetate
对-甲苯氧基乙酸乙酯	Ethyl (p-tolyloxy) acetate
乙酸二甲基苯乙基原酯	Dimethyl phenethyl carbinyl acetate
丙酸甲基苯基原酯	Methyl phenylcarbinyl propionate
2-呋喃基丙烯酸丙酯	Propyl 2-furanacrylate
异丁酸二甲基苯乙基原酯	Dimethyl phenethyl carbinyl isobutyrate
异丁酸2-苯氧基乙酯	2-Phenoxyethyl isobutyrate
十三碳二酸环乙二醇二酯	Ethylene brassylate
邻氨基苯甲酸异丁酯	Isobutyl anthranilate
对-叔丁基苯乙酸甲酯	Methyl p-tert-butylphenylacetate
苯氧乙酸烯丙酯	Allyl phenoxyacetate
苯乙酸辛酯	Octyl phenylaceteate
苯乙酸苄酯	Benzyl phenylacetate
苯乙酸芳樟酯	Linalyl phenylacetate
苯乙酸香茅酯	Citronellyl phenylacetate
苯乙酸愈创木酚酯	Guaiacyl phenylacetate
3-甲基2-丁烯酸2-苯乙酯|千里酸苯乙酯	2-phenethy l3-Methyl-2-butenoate|Phenethyl senecioate
3-苯基缩水甘油酸乙酯	Ethyl 3-phenylglycidate
肉桂酸芳樟酯	Linalyl cinnamate
1,2-二[(1'-乙氧基)-乙氧基]丙烷	1,2-Di[(1'-ethoxy)ethoxy]propane
N,2,3-三甲基-2-异丙基丁酰胺	2-Isopropyl-N,2,3-trimethylbutyramide
N-乙基-2-异丙基-5-甲基-环己烷甲酰胺	N-Ethyl-2-isopropyl-5-methylcyclohexane carboxamide
3-l-?氧基-1,2-丙二醇|3-l-薄荷烷氧基-1,2-丙二醇	3-l-Menthoxypropane-1,2-diol
香兰基丁醚	Vanillyl butyl ether
9-癸烯醛	9-Decenal
2-仲丁基环己酮	2-sec-Butylcyclohexanone
2,3-十一碳二酮	2,3-Undecadione
环己烷基甲酸	Cyclohexanecarboxylic acid
5和6-癸烯酸|牛奶内酯	5-and6-Decenoic acid|Milklactone
八乙酸蔗糖酯	Sucrose octaacetate
丁酸烯丙酯	Allyl butyrate
异丁酸香兰素酯	Vanillin isobutyrate
戊二酸单l-薄荷醇酯	l-Monomenthyl glutarate
苯甲酰基乙酸乙酯	Ethyl benzoylacetate
ε-十二内酯	ε-Dodecalactone
八氢香豆素	Octahydrocoumarin
2,5-二甲基-3-呋喃硫醇	2,5-Dimethyl-3-furathiol
1,2-丁二硫醇	1,2-Butanedithiol
双-(2,5-二甲基-3-呋喃基)二硫醚	Bis(2,5-dimethyl-3-furyl) disufide
丙基2-甲基-3-呋喃基二硫醚	Propyl 2-methyl-3-furyl disulfide
二环己基二硫醚	Dicyclohexyl disulfide
糠基异丙基硫醚	Furfuryl isopropyl sulfide
2-乙基苯硫酚	2-Ethyl thiophenol
2-(乙酰氧基)丙酸甲硫醇酯	Methylthio 2-(acetyloxy) propionate
2-(丙酰氧基)丙酸甲硫醇酯	Methylthio 2-(propionyloxy) propionate
3-糠硫基丙酸乙酯	Ethyl 3-(furfurylthio) propionate
2-甲硫基吡嗪	2-Methylthiopyrazine
异硫氰酸苯乙酯	Phenethyl isothiocyanate
3-(3-苯丙基)吡啶	2-(3-Phenylpropyl) pyridine
4,5-二甲基-2-乙基-3-噻唑啉	4,5-Dimethyl-2-ethyl-3-thiazoline
2-仲丁基-4,5-二甲基-3-噻唑啉	2-(2-Butyl)-4,5-dimethyl-3-thiazoline
吡嗪乙硫醇	Pyrazineethanethiol
水杨酸苯酯	Phenyl salicylate
庚醛二甲缩醛	Heptanal dimethyl acetal
羟基香茅醛二甲缩醛	Hydroxy citronellal dimethyl acetal
对-丙基茴香醚	p-Propyl anisole
异丁酸对-甲酚酯	p-Tolyl isobutyrate
异丁酸邻-甲酚酯	o-Tolyl isobutyrate
柠檬醛丙二醇缩醛	Citral propylene glycol acetal
反式-2-己烯醛二乙缩醛	trans-2-Hexenal diethyl acetal
2-巯基噻吩	2-Mercaptothiophene
对-?-3,8-二醇|对-3,8-薄荷烷二醇	p-Menth-3,8-diol4053
1,8-辛二硫醇	1,8-Octanedithiol
螺[2,4-二硫杂-1-甲基-8-氧杂双环[3.3.0]-辛烷-3,3'-(1'-氧杂-2'-甲基)环戊烷]	spiro[2,4-Dithia-1-methyl-8-oxabicyclo[3.3.0]octane-3,3'-(1'-oxa-2'-methyl)cyclopentane]
3-壬烯-2-酮	3-Nonen-2-one
3-甲基-2,4-壬二酮	3-Methyl-2,4-nonadione
2,5-二甲基-3-硫代乙酰氧基呋喃	2,5-Dimethyl-3-thioacetoxyfuran
反式-4-己烯醛	trans-4-Hexenal
3-[(2-甲基-3-呋喃)硫基]-2-丁酮	(+/-)-3-[(2-Methyl-3-furyl)thio]-2-butanone
3-巯基-2-甲基戊醛	3-Mercapto-2-methylpentanal
2-(l-?氧基)乙醇|2-(l-薄荷烷氧基乙醇)	2-(l-Menthoxy)ethanol
丙酸四氢糠酯	Tetrahydrofurfuryl propionate
异戊酸烯丙酯	Allyl isovalerate
4-辛酮-1-醇	3-Octanon-1-ol
三丙酸甘油酯	Glyceryl tripropanoate
辛酸α-糠酯	α-Furfuryl octanoate
丁酸反式-2-辛烯醇酯	trans-2-Octen-1-yl butanoate
苯乙醛二异丁缩醛	Phenylacetalde hydediisobutyl acetal
1,3-二苯基-2-丙酮	1,3-Diphenyl-2-propanone
10-十一烯酸丁酯	Butyl 10-undecylenate
乙酸檀香酯	Santalyl acetate
2-乙基丁酸香叶酯	Geranyl 2-ethylbutyrate
3-羟甲基-2-辛酮	3-Hydroxymethyl-2-octanone
1,2-环己二酮	1,2-Cyclohexanedione
松香甘油酯	Glycerol ester of rosin
赤、苏-3-巯基-2-甲基丁-1-醇|3-巯基-2-甲基丁醇	rythro and threo-3-Mercapto-2-methylbutan-1-ol|3-Mercapto-2-methylbutyl alcohol
4-甲基联苯	4-Methyl biphenyl
α-戊基肉桂醇	α-Amylcinnamyl alcohol
1-苯基-3-甲基-戊醇-3	1-phenyl-3-methyl-3-pentanol
5-苯基戊醇	5-Phenylpentanol
对- 烷醇-2|对-薄荷烷醇-2	p-Menthan-2-ol
脱氢二氢紫罗兰醇	Dehydrodihydroionol
乙基葑醇	Ethyl fenchol
辛烯基琥珀酸单阿拉伯胶酯	Gum Arabic,hydrogen octenylbutane dioate
N1-(2-甲氧基-4-甲基苄基)-N2-[2-(5-甲基-2-吡啶基)乙基]草酰胺	N1-(2-methoxy-4-methylbenzyl)-N2-[2-(5-methylpyridin-2-yl)ethyl]oxalamide
N1-(2,4-二甲氧基苄基)-N2-[2-(2-吡啶基)乙基]草酰胺	N1-(2,4-dimethoxybenzyl)-N2-[2-(pyridin-2-yl)ethyl]oxalamide
N-(4-庚基)-(3,4-亚甲二氧基)苯甲酰胺	N-(heptan-4-yl)benzo[d][1,3]dioxole-5-carboxamide
二苄醚	Dibenzyl ether
5-羟基-十二酸甘油酯	Glyceryl5-hydroxydodecanoate
三丁酸甘油酯	Tributyrin
壬酸烯丙酯	Allyl nonanoate
5-羟基癸酸甘油酯	Glyceryl5-hydroxydecanoate
丙酸3-苯基丙酯	3-Phenylpropyl propionate
肉桂酸异丙酯	Isopropyl cinnamate
2-酮基-4-丁硫醇	2-Keto-4-butanethiol
甲基-对-甲苯缩水甘油酸乙酯	Ethyl methyl-p-toly glycidate
5-羟基-8-十一碳烯酸δ-内酯	5-Hydroxy-8-undecenoic acid delta-lactone
N-环丙基-反式-2-顺式-6-壬二烯酰胺	N-Cyclopropyl-(E)2,(Z)6-nonadienamide
N-乙基-反式-2-顺式-6-壬二烯酰胺	N-Ethyl-(E)2,(Z)6-nonadienamide
2,4-二甲基-1,3-二氧戊环|乙醛1,2-丙二醇缩醛	2,4-Dimethyl-1,3-dioxolane|Acetaldehyde propylene	glycol acetal
β-萘甲醚	β-Naphthyl methyl ether
二羟基丙酮	Dihydroxyacetone
二苯基二硫醚	Phenyl disulfide
乙基香芹酚	Ethyl carvacrol
甲基苯甲醛甘油缩醛(邻、间、对异构体混合物)	Tolualdehyde glyceryl acetal (o-,m-,pmixed isomers)
(+/-)-反式和顺式-4,8-二甲基-3,7-壬二烯-2-醇	(+/-)-trans-and cis-4,8-Dimethyl-3,7-nona-dien-2-ol
(+/-)-反式和顺式-4,8-二甲基-3,7-壬二烯-2-醇乙酸酯	(+/-)-trans-and cis-4,8-Dimethyl-3,7-nona-dien-2-yl acetate
(反式和顺式)-1-甲氧基-1-癸烯	trans-and cis-1-Methoxy-1-decene
2-(4-甲基-5-噻唑基)乙醇癸酸酯	2-(4-Methyl-5-thiazolyl)ethyl decanoate
2-(4-甲基-5-噻唑基)乙醇异丁酸酯	2-(4-Methyl-5-thiazolyl) ethyl isobutyrate
2-(4-甲基-5-噻唑基)乙醇甲酸酯	2-(4-Methyl-5-thiazolyl) ethyl formate
异戊酸3-苯丙酯	3-Phenylpropyl isovalerate
dl-薄荷脑(+/-)-1,2-丙二醇碳酸酯	dl-Metho(+/-)-propylene glycol carbonate
乙酸1-乙氧基乙醇酯	1-Ethoxyethyl acetate
N-异丁基-反-2-反-4-癸二烯酸酰胺	N-Isobutyldeca-trans-2-trans-4-dienamide
二苯乙醇酮|2-羟基-2-苯基苯乙酮	Benzoin|2-Hydroxy-2-phenylacetophenone
甲基异戊基二硫醚	Methyl isopentyl disulfide
邻氨基苯甲酸烯丙酯	Allyl anthranilate
6-环己基己酸烯丙酯	Allyl cyclohexanehexanoate
5-环己基戊酸烯丙酯	Allyl cyclohexanevalerate
2-乙基丁酸烯丙酯	Allyl2-ethylbutyrate
惕各酸烯丙酯|反式-2-甲基-2-丁烯酸烯丙酯	Allyl tiglate Allyl trans-2-methyl-2-butenoate
10-十一烯酸烯丙酯	Allyl 10-undecenoate
α-戊基肉桂醛二甲缩醛	α-Amylcinnamaldehyde dimethyl acetal
乙酸α-戊基肉桂酯	α-Amylcinnamyl acetate
甲酸α-戊基肉桂酯	α-Amylcinnamyl formate
异戊酸α-戊基肉桂酯	α-Amylcinnamyl isovalerate
4(2-呋喃基)丁酸异戊酯	Isoamyl 4(2-furan) butyrate
3(2-呋喃基)丙酸异戊酯	Isoamyl 3(2-furan) propionate
2-戊基-5或6-酮-1,4-二噁烷	2-Amyl-5 or 6-keto-1,4-dioxane
丙酮酸异戊酯	Isoamyl pyruvate
苄基丁基醚	Benzyl butyl ether
N-3,7-二甲基-2,6-辛二烯-环丙基甲酰胺	N-3,7-Dimethyl-2,6-octadienylcyclopropylcarboxamide
N-(乙氧羰基甲基)-对-?烷-3-甲酰胺|N-(乙氧羰基甲基)-对-薄荷烷-3-甲酰胺	[N-(Ethoxycarbonyl)methyl]-p-menthane-3-carboxamide
硬木烟熏香味料 SmokEzC-10	SmokEzC-10
硬木烟熏香味料 SEF7525	Scansmoke SEF 7525
(反式,顺式)-2,6-壬二烯-1-醇乙酸酯	(E,Z)-2,6-Nonadien-1-ol acetate
邻氨基苯甲酸苯乙酯	Phenylethyl anthranilate
2-丙酰基-2-噻唑啉	2-Propionyl-2-thiazoline
顺式-8-十四烯醛	(Z)-8-Tetradecenal
烯丙硫醇己酸酯	Allylthiohexanoate
双香兰素	Divanillin
顺式和反式-2-庚基环丙烷羧酸	cis-andtrans-2-Heptylcyclopropane carboxylic acid
5-羟基-4-甲基己酸δ-内酯	5-Hydroxy-4-methylhexanoic acid δ-lactone
4-巯基-2-戊酮	4-Mercapto-2-pentanone
2,4,6-三硫杂庚烷	2,4,6-Trithiaheptane
1-(4-甲氧苯基)-4-甲基-1-戊烯-3-酮	1-(4-Methoxyphenyl)-4-methyl-1-penten-3-one
3(2)-羟基-5-甲基-2(3)-己酮	3(2)-Hydroxy-5-methyl-2(3)-hexanone
二巯基甲烷	Dimercaptomethane
4-羟基-2-丁烯酸γ-内酯|2(5H)-呋喃酮	4-Hydroxy-2-butenoic acid γ-lactone|2(5H)-furanone
(+/-)-3-甲硫基丁酸异丁酯	(+/-)-Isobutyl 3-methylthiobutyrate
3-甲硫基-2-丁酮	3-(Methylthio)-2-butanone
顺式和反式-5-乙基-4-甲基-2-(2-甲基丙基)-噻唑啉	cis-and trans-5-Ethyl-4-methyl-2-(2-methylpropyl)-thiazoline
1-戊硫醇	1-Pentanethiol
(+/-)-4-巯基-4-甲基-2-戊醇	(+/-)-4-Mercapto-4-methyl-2-pentanol
异戊酸环己酯	Cyclohexyl isovalerate
2-噻吩基二硫醚	2-Thienyl disulfide
双(2-甲基-3-呋喃基)四硫醚	Bis(2-methyl-3-furyl) tetrasulfide
辛酸对-甲酚酯	p-Tolyl octanoate
丙酸麦芽酚酯	Maltol propionate
顺式-2-己烯-1-醇	(Z)-2-Hexen-1-ol
(+/-)反式和顺式-2-己烯醛丙二醇缩醛	(+/-)trans-and cis-2-Hexenal propylene glycol acetal
乙酸2-乙基丁酯	2-Ethylbutyl acetate
2,5-二乙基-3-甲基吡嗪	2,5-Diethyl-3-methylpyrazine
4-(甲硫基)-2-戊酮	4-(Methylthio)-2-pentanone
甲硫基甲硫醇	Methylthiomethylmercaptan
顺式和反式-5-乙基-4-甲基-2-(1-甲基丙基)-噻唑啉	cis-and trans-5-Ethyl-4-methyl-2-(1-methylpropyl)-thiazoline
辛醛二甲缩醛	Octanal dimethyl acetal
3-巯基-3-甲基-1-丁醇乙酸酯	3-Mercapto-3-methyl-1-butyl acetate
(R,S)-3-羟基丁酸l-薄荷酯	l-Menthyl(R,S)-3-hydroxybutyrate
异戊酸异丙酯	Isopropyl isovalerate
顺式-4-癸烯醇乙酸酯	cis-4-Decenyl acetate
惕各酸香叶酯	Geranyl tiglate
N-苯甲酰邻氨基苯甲酸	N-Benzoylanthranilic acid
2,6,10-三甲基-2,6,10-十五碳三烯-14-酮	2,6,10-Trimethyl-2,6,10-pentadecatrien-14-one
2,5-二甲基噻唑	2,5-Dimethylthiazole
甲硫基甲醇丁酸酯	Methylthiomethyl butyrate
2-甲硫基乙醇	2-(Methylthio) ethanol
二乙基三硫醚	Diethyl trisulfide
顺式和反式-1-巯基-对-?烷-3-酮|顺式和反式-1-巯基-对-薄荷烷-3-酮	cis-and trans-1-Mercapto-p-menthan-3-one
4-羟基-4-甲基-7-顺式-癸烯酸γ-内酯	4-Hydroxy-4-methyl-7-cis-decenoic acid gamma lactone
2-甲基辛醛	2-Methyloctanal
3-甲基-5-丙基-2-环己烯-1-酮	3-Methyl-5-propyl-2-cyclohexen-1-one
2,4-壬二烯-1-醇	2,4-Nonadien-1-ol
环戊硫醇	Cyclopentanethiol
N-对苯乙腈基薄荷烷基甲酰胺	N-p-Benzeneacetonitrile menthanecarboxamide
N-[2-(吡啶-2-基)乙基]薄荷烷基甲酰胺	N-[2-(Pyridin-2-yl)ethyl]-3-p-menthanecar boxamide
4-氨基-5,6-二甲基噻吩并[2,3-d]嘧啶-2(1H)-酮盐酸盐	4-Amino-5,6-dimethylthieno[2,3-d]pyrimidin-2(1H)-onehydrochloride
3-[(4-氨基-2,2-二氧-1H-2,1,3-苯并噻二嗪-5-基)氧]-2,2-二甲基-N-丙基丙酰胺	3-[(4-Amino-2,2-dioxido-1H-2,1,3-benzothiadiazin-5-yl) oxy]-2,2-dimethyl-N-propylpropanamide
L-蛋氨酰基甘氨酸盐酸盐	L-Methionylglycine.HCl
5-戊基-3H-呋喃-2-酮	5-Pentyl-3H-furan-2-one
2,5-二硫杂己烷	2,5-Dithiahexane
(2S,5R)-N-[4-(2-氨基-2-氧代乙基)苯基]-5-甲基-2-(丙 基-2-)环己烷甲酰胺	(2S,5R)-N-[4-(2-Amino-2-oxoethyl)phenyl]-5-methyl-2-(propan-2-yl)cyclohexanecarboxamide
5-甲基-2-呋喃甲硫醇|5-甲基糠硫醇	5-Methyl-2-furanmethanethiol|5-Methylfurfurylmercaptan